FISHCARD_elas_01.1	Eukaryota;Chordata;Chondrichthyes;Carcharhiniformes;Carcharhinidae;Galeocerdo;Galeocerdo cuvier
FISHCARD_elas_02.1	Eukaryota;Chordata;Chondrichthyes;Carcharhiniformes;Triakidae;Galeorhinus;Galeorhinus galeus
FISHCARD_elas_03.1	Eukaryota;Chordata;Chondrichthyes;Heterodontiformes;Heterodontidae;Heterodontus;Heterodontus francisci
FISHCARD_elas_04.1	Eukaryota;Chordata;Chondrichthyes;Lamniformes;Alopiidae;Isurus;Isurus oxyrinchus
FISHCARD_elas_05.1	Eukaryota;Chordata;Chondrichthyes;Carcharhiniformes;Carcharhinidae;Rhizoprionodon;Rhizoprionodon longurio
FISHCARD_elas_06.1	Eukaryota;Chordata;Chondrichthyes;Carcharhiniformes;Carcharhinidae;Sphyrna;Sphyrna zygaena
FISHCARD_elas_07.1	Eukaryota;Chordata;Chondrichthyes;Myliobatiformes;Myliobatidae;Mobula;Mobula mobular
FISHCARD_elas_08.1	Eukaryota;Chordata;Chondrichthyes;Myliobatiformes;Dasyatidae;Pteroplatytrygon;Pteroplatytrygon violacea
FISHCARD_elas_10.1	Eukaryota;Chordata;Chondrichthyes;Myliobatiformes;Myliobatidae;Mobula;Mobula thurstoni
FISHCARD_elas_11.1	Eukaryota;Chordata;Chondrichthyes;Pristiformes/Rhiniformes group;Rhinobatidae;Pseudobatos;Pseudobatos productus
FISHCARD_elas_12.1	Eukaryota;Chordata;Chondrichthyes;Myliobatiformes;Gymnuridae;Gymnura;Gymnura marmorata
FISHCARD_elas_13.1	Eukaryota;Chordata;Chondrichthyes;Squaliformes;Dalatiidae;Euprotomicrus;Euprotomicrus bispinatus
FISHCARD_elas_14.1	Eukaryota;Chordata;Chondrichthyes;Lamniformes;Alopiidae;Alopias;Alopias superciliosus
FISHCARD_elas_15.1	Eukaryota;Chordata;Chondrichthyes;Carcharhiniformes;Carcharhinidae;Carcharhinus;Carcharhinus longimanus
FISHCARD_elas_16.1	Eukaryota;Chordata;Chondrichthyes;Carcharhiniformes;Carcharhinidae;Prionace;Prionace glauca
FISHCARD_elas_17.1	Eukaryota;Chordata;Chondrichthyes;Chimaeriformes;Chimaeridae;Hydrolagus;Hydrolagus colliei
FISHCARD_elas_18.1	Eukaryota;Chordata;Chondrichthyes;Squaliformes;Dalatiidae;Euprotomicrus;Euprotomicrus bispinatus
FISHCARD_elas_19.1	Eukaryota;Chordata;Chondrichthyes;Squaliformes;Somniosidae;Somniosus;Somniosus pacificus
FISHCARD_elas_20.1	Eukaryota;Chordata;Chondrichthyes;Myliobatiformes;Dasyatidae;Hypanus;Hypanus dipterurus
FISHCARD_elas_21.1	Eukaryota;Chordata;Chondrichthyes;Lamniformes;Alopiidae;Carcharodon;Carcharodon carcharias
FISHCARD_elas_22.1	Eukaryota;Chordata;Chondrichthyes;Myliobatiformes;Gymnuridae;Gymnura;Gymnura marmorata
FISHCARD_elas_23.1	Eukaryota;Chordata;Chondrichthyes;Hexanchiformes;Hexanchidae;Hexanchus;Hexanchus griseus
FISHCARD_elas_24.1	Eukaryota;Chordata;Actinopteri;Lophiiformes;Himantolophidae;Himantolophus;Himantolophus sagamius
FISHCARD_elas_25.1	Eukaryota;Chordata;Chondrichthyes;Rajiformes;Arhynchobatidae;Bathyraja;Bathyraja trachura
FISHCARD_elas_26.1	Eukaryota;Chordata;Chondrichthyes;;Platyrhinidae;Platyrhinoidis;Platyrhinoidis triseriata
FISHCARD_elas_27.1	Eukaryota;Chordata;Chondrichthyes;Pristiformes/Rhiniformes group;Rhinobatidae;Pseudobatos;Pseudobatos productus
FISHCARD_elas_28.1	Eukaryota;Chordata;Chondrichthyes;Carcharhiniformes;Scyliorhinidae;Parmaturus;Parmaturus xaniurus
FISHCARD_elas_29.1	Eukaryota;Chordata;Chondrichthyes;Carcharhiniformes;Triakidae;Mustelus;Mustelus californicus
FISHCARD_elas_30.1	Eukaryota;Chordata;Chondrichthyes;Carcharhiniformes;Triakidae;Triakis;Triakis semifasciata
FISHCARD_elas_31.1	Eukaryota;Chordata;Chondrichthyes;Myliobatiformes;Urolophidae;Urobatis;Urobatis halleri
FISHCARD_elas_32.1	Eukaryota;Chordata;Chondrichthyes;Lamniformes;Alopiidae;Alopias;Alopias superciliosus
FISHCARD_elas_33.1	Eukaryota;Chordata;Chondrichthyes;Hexanchiformes;Hexanchidae;Notorynchus;Notorynchus cepedianus
FISHCARD_elas_34.1	Eukaryota;Chordata;Chondrichthyes;Lamniformes;Alopiidae;Alopias;Alopias pelagicus
FISHCARD_elas_35.1	Eukaryota;Chordata;Chondrichthyes;Torpediniformes;Torpedinidae;Tetronarce;Tetronarce californica
FISHCARD_elas_36.1	Eukaryota;Chordata;Chondrichthyes;Rajiformes;Rajidae;Raja;Beringraja binoculata
FISHCARD_elas_37.1	Eukaryota;Chordata;Chondrichthyes;Myliobatiformes;Dasyatidae;Pteroplatytrygon;Pteroplatytrygon violacea
FISHCARD_elas_38.1	Eukaryota;Chordata;Chondrichthyes;Carcharhiniformes;Triakidae;Mustelus;Mustelus henlei
FISHCARD_elas_39.1	Eukaryota;Chordata;Chondrichthyes;Carcharhiniformes;Scyliorhinidae;Apristurus;Apristurus brunneus
FISHCARD_elas_40.1	Eukaryota;Chordata;Chondrichthyes;Rajiformes;Rajidae;Raja;Beringraja rhina
FISHCARD_elas_41.1	Eukaryota;Chordata;Chondrichthyes;Carcharhiniformes;Scyliorhinidae;Apristurus;Apristurus kampae
FISHCARD_elas_42.1	Eukaryota;Chordata;Chondrichthyes;Rajiformes;Rajidae;Raja;Beringraja inornata
FISHCARD_elas_43.1	Eukaryota;Chordata;Chondrichthyes;Carcharhiniformes;Scyliorhinidae;Cephaloscyllium;Cephaloscyllium ventriosum
FISHCARD_elas_44.1	Eukaryota;Chordata;Chondrichthyes;Rajiformes;Arhynchobatidae;Bathyraja;Bathyraja interrupta
FISHCARD_elas_45.1	Eukaryota;Chordata;Chondrichthyes;Rajiformes;Rajidae;Raja;Beringraja stellulata
FISHCARD_elas_46.1	Eukaryota;Chordata;Chondrichthyes;Rajiformes;Arhynchobatidae;Bathyraja;Bathyraja abyssicola
FISHCARD_elas_47.1	Eukaryota;Chordata;Chondrichthyes;Rajiformes;Rajidae;Amblyraja;Amblyraja hyperborea
FISHCARD_elas_48.1	Eukaryota;Chordata;Chondrichthyes;Orectolobiformes;Rhincodontidae;Rhincodon;Rhincodon typus
FISHCARD_elas_49.1	Eukaryota;Chordata;Chondrichthyes;Squaliformes;Squalidae;Squalus;Squalus suckleyi
FISHCARD_elas_50.1	Eukaryota;Chordata;Chondrichthyes;;Squatinidae;Squatina;Squatina californica
FISHCARD_elas_51.1	Eukaryota;Chordata;Chondrichthyes;Lamniformes;Megachasmidae;Megachasma;Megachasma pelagios
FISHCARD_elas_52.1	Eukaryota;Chordata;Chondrichthyes;Carcharhiniformes;Triakidae;Mustelus;Mustelus lunulatus
FISHCARD_elas_53.1	Eukaryota;Chordata;Chondrichthyes;Pristiformes/Rhiniformes group;Rhinobatidae;Zapteryx;Zapteryx exasperata
FISHCARD_elas_54.1	Eukaryota;Chordata;Chondrichthyes;Squaliformes;Dalatiidae;Euprotomicrus;Euprotomicrus sp.
FISHCARD_miu_001.1	Eukaryota;Chordata;Actinopteri;Argentiniformes;Microstomatidae;Nansenia;Nansenia candida
FISHCARD_miu_002.1	Eukaryota;Chordata;Actinopteri;Syngnathiformes;Syngnathidae;Syngnathus;Syngnathus leptorhynchus
FISHCARD_miu_003.1	Eukaryota;Chordata;Actinopteri;Perciformes;Liparidae;Nectoliparis;Nectoliparis pelagicus
FISHCARD_miu_004.1	Eukaryota;Chordata;Actinopteri;Perciformes;Zaniolepididae;Zaniolepis;Zaniolepis frenata
FISHCARD_miu_005.1	Eukaryota;Chordata;Actinopteri;Blenniiformes;Gobiesocidae;Gobiesox;Gobiesox maeandricus
FISHCARD_miu_006.1	Eukaryota;Chordata;Actinopteri;Gadiformes;Merlucciidae;Merluccius;Merluccius productus
FISHCARD_miu_007.1	Eukaryota;Chordata;Actinopteri;Gadiformes;Macrouridae;Coelorinchus;Coelorinchus scaphopsis
FISHCARD_miu_008.1	Eukaryota;Chordata;Actinopteri;;Sciaenidae;Roncador;Roncador stearnsii
FISHCARD_miu_009.1	Eukaryota;Chordata;Actinopteri;Scombriformes;Scombridae;Scomber;Scomber japonicus
FISHCARD_miu_010.1	Eukaryota;Chordata;Actinopteri;Scombriformes;Icosteidae;Icosteus;Icosteus aenigmaticus
FISHCARD_miu_011.1	Eukaryota;Chordata;Actinopteri;;Sphyraenidae;Sphyraena;Sphyraena argentea
FISHCARD_miu_012.1	Eukaryota;Chordata;Actinopteri;Lampriformes;Trachipteridae;Trachipterus;Trachipterus altivelis
FISHCARD_miu_013.1	Eukaryota;Chordata;Actinopteri;Myctophiformes;Myctophidae;Protomyctophum;Protomyctophum crockeri
FISHCARD_miu_014.1	Eukaryota;Chordata;Actinopteri;Pleuronectiformes;Pleuronectidae;Parophrys;Parophrys vetulus
FISHCARD_miu_015.1	Eukaryota;Chordata;Actinopteri;Pleuronectiformes;Pleuronectidae;Microstomus;Microstomus pacificus
FISHCARD_miu_016.1	Eukaryota;Chordata;Actinopteri;Pleuronectiformes;Pleuronectidae;Glyptocephalus;Glyptocephalus zachirus
FISHCARD_miu_017.1	Eukaryota;Chordata;Actinopteri;Pleuronectiformes;Pleuronectidae;Lyopsetta;Lyopsetta exilis
FISHCARD_miu_018.1	Eukaryota;Chordata;Actinopteri;Gadiformes;Melanonidae;Melanonus;Melanonus zugmayeri
FISHCARD_miu_019.1	Eukaryota;Chordata;Actinopteri;Pleuronectiformes;Pleuronectidae;Psettichthys;Psettichthys melanostictus
FISHCARD_miu_020.1	Eukaryota;Chordata;Actinopteri;Clupeiformes;Engraulidae;Engraulis;Engraulis mordax
FISHCARD_miu_021.1	Eukaryota;Chordata;Actinopteri;Stomiiformes;Sternoptychidae;Sternoptyx;Sternoptyx obscura
FISHCARD_miu_022.1	Eukaryota;Chordata;Actinopteri;Stomiiformes;Sternoptychidae;Sternoptyx;Sternoptyx pseudobscura
FISHCARD_miu_023.1	Eukaryota;Chordata;Actinopteri;Stomiiformes;Stomiidae;Stomias;Stomias atriventer
FISHCARD_miu_024.1	Eukaryota;Chordata;Actinopteri;Stomiiformes;Phosichthyidae;Vinciguerria;Vinciguerria nimbaria
FISHCARD_miu_025.1	Eukaryota;Chordata;Actinopteri;Stomiiformes;Phosichthyidae;Vinciguerria;Vinciguerria lucetia
FISHCARD_miu_026.1	Eukaryota;Chordata;Actinopteri;Myctophiformes;Myctophidae;Stenobrachius;Stenobrachius leucopsarus
FISHCARD_miu_027.1	Eukaryota;Chordata;Actinopteri;Beryciformes;Melamphaidae;Scopelogadus;Scopelogadus bispinosus
FISHCARD_miu_028.1	Eukaryota;Chordata;Actinopteri;Myctophiformes;Myctophidae;Notoscopelus;Notoscopelus resplendens
FISHCARD_miu_029.1	Eukaryota;Chordata;Actinopteri;Myctophiformes;Myctophidae;Triphoturus;Triphoturus nigrescens
FISHCARD_miu_030.1	Eukaryota;Chordata;Actinopteri;Myctophiformes;Myctophidae;Lobianchia;Lobianchia gemellarii
FISHCARD_miu_031.1	Eukaryota;Chordata;Actinopteri;Myctophiformes;Myctophidae;Diaphus;Diaphus theta
FISHCARD_miu_032.1	Eukaryota;Chordata;Actinopteri;Myctophiformes;Myctophidae;Centrobranchus;Centrobranchus nigroocellatus
FISHCARD_miu_033.1	Eukaryota;Chordata;Actinopteri;Aulopiformes;Paralepididae;Lestidiops;Lestidiops pacificus
FISHCARD_miu_034.1	Eukaryota;Chordata;Actinopteri;Beryciformes;Melamphaidae;Melamphaes;Melamphaes simus
FISHCARD_miu_035.1	Eukaryota;Chordata;Actinopteri;Atheriniformes;Atherinopsidae;Leuresthes;Leuresthes tenuis
FISHCARD_miu_036.1	Eukaryota;Chordata;Actinopteri;Carangiformes;Carangidae;Trachurus;Trachurus symmetricus
FISHCARD_miu_037.1	Eukaryota;Chordata;Actinopteri;Blenniiformes;Gobiesocidae;Gobiesox;Gobiesox rhessodon
FISHCARD_miu_038.1	Eukaryota;Chordata;Actinopteri;Ophidiiformes;Ophidiidae;Ophidion;Ophidion scrippsae
FISHCARD_miu_039.1	Eukaryota;Chordata;Actinopteri;Perciformes;Sebastidae;Sebastes;Sebastes semicinctus
FISHCARD_miu_040.1	Eukaryota;Chordata;Actinopteri;Perciformes;Sebastidae;Sebastes;Sebastes saxicola
FISHCARD_miu_041.1	Eukaryota;Chordata;Actinopteri;Perciformes;Sebastidae;Sebastes;Sebastes rastrelliger
FISHCARD_miu_042.1	Eukaryota;Chordata;Actinopteri;Perciformes;Sebastidae;Sebastes;Sebastes babcocki
FISHCARD_miu_043.1	Eukaryota;Chordata;Actinopteri;;Embiotocidae;Phanerodon;Phanerodon vacca
FISHCARD_miu_044.1	Eukaryota;Chordata;Actinopteri;;Embiotocidae;Phanerodon;Phanerodon furcatus
FISHCARD_miu_045.1	Eukaryota;Chordata;Actinopteri;;Embiotocidae;Micrometrus;Micrometrus minimus
FISHCARD_miu_046.1	Eukaryota;Chordata;Actinopteri;;Embiotocidae;Hyperprosopon;Hyperprosopon argenteum
FISHCARD_miu_047.1	Eukaryota;Chordata;Actinopteri;Syngnathiformes;Syngnathidae;Syngnathus;Syngnathus exilis
FISHCARD_miu_048.1	Eukaryota;Chordata;Actinopteri;Syngnathiformes;Centriscidae;Macroramphosus;Macroramphosus gracilis
FISHCARD_miu_049.1	Eukaryota;Chordata;Actinopteri;Syngnathiformes;Syngnathidae;Hippocampus;Hippocampus ingens
FISHCARD_miu_050.1	Eukaryota;Chordata;Actinopteri;Syngnathiformes;Syngnathidae;Cosmocampus;Cosmocampus arctus
FISHCARD_miu_051.1	Eukaryota;Chordata;Actinopteri;Perciformes;Agonidae;Bathyagonus;Bathyagonus pentacanthus
FISHCARD_miu_052.1	Eukaryota;Chordata;Actinopteri;Perciformes;Zaniolepididae;Zaniolepis;Zaniolepis latipinnis
FISHCARD_miu_053.1	Eukaryota;Chordata;Actinopteri;Blenniiformes;Blenniidae;Hypsoblennius;Hypsoblennius gilberti
FISHCARD_miu_054.1	Eukaryota;Chordata;Actinopteri;Blenniiformes;Blenniidae;Hypsoblennius;Hypsoblennius gentilis
FISHCARD_miu_055.1	Eukaryota;Chordata;Actinopteri;Perciformes;Zoarcidae;Eucryphycus;Eucryphycus californicus
FISHCARD_miu_056.1	Eukaryota;Chordata;Actinopteri;Perciformes;Anarhichadidae;Anarrhichthys;Anarrhichthys ocellatus
FISHCARD_miu_057.1	Eukaryota;Chordata;Actinopteri;Scombriformes;Chiasmodontidae;Chiasmodon;Chiasmodon subniger
FISHCARD_miu_059.1	Eukaryota;Chordata;Actinopteri;Gobiiformes;Gobiidae;Rhinogobiops;Rhinogobiops nicholsii
FISHCARD_miu_060.1	Eukaryota;Chordata;Actinopteri;Gobiiformes;Gobiidae;Gillichthys;Gillichthys mirabilis
FISHCARD_miu_061.1	Eukaryota;Chordata;Actinopteri;Lophiiformes;Oneirodidae;Oneirodes;Oneirodes acanthias
FISHCARD_miu_062.1	Eukaryota;Chordata;Actinopteri;Blenniiformes;Blenniidae;Plagiotremus;Plagiotremus azaleus
FISHCARD_miu_063.1	Eukaryota;Chordata;Actinopteri;Blenniiformes;Labrisomidae;Labrisomus;Labrisomus xanti
FISHCARD_miu_064.1	Eukaryota;Chordata;Actinopteri;Blenniiformes;Blenniidae;Hypsoblennius;Hypsoblennius jenkinsi
FISHCARD_miu_065.1	Eukaryota;Chordata;Actinopteri;Perciformes;Sebastidae;Sebastes;Sebastes gilli
FISHCARD_miu_066.1	Eukaryota;Chordata;Chondrichthyes;Carcharhiniformes;Carcharhinidae;Galeocerdo;Galeocerdo cuvier
FISHCARD_miu_067.1	Eukaryota;Chordata;Chondrichthyes;Carcharhiniformes;Triakidae;Galeorhinus;Galeorhinus galeus
FISHCARD_miu_068.1	Eukaryota;Chordata;Chondrichthyes;Carcharhiniformes;Carcharhinidae;Sphyrna;Sphyrna zygaena
FISHCARD_miu_069.1	Eukaryota;Chordata;Chondrichthyes;Myliobatiformes;Myliobatidae;Mobula;Mobula mobular
FISHCARD_miu_070.1	Eukaryota;Chordata;Actinopteri;Lutjaniformes;Haemulidae;Haemulon;Haemulon flaviguttatum
FISHCARD_miu_071.1	Eukaryota;Chordata;Actinopteri;Perciformes;Serranidae;Mycteroperca;Mycteroperca jordani
FISHCARD_miu_072.1	Eukaryota;Chordata;Actinopteri;;Moronidae;Morone;Morone saxatilis
FISHCARD_miu_073.1	Eukaryota;Chordata;Actinopteri;Argentiniformes;Opisthoproctidae;Dolichopteryx;Dolichopteryx longipes
FISHCARD_miu_074.1	Eukaryota;Chordata;Actinopteri;Gadiformes;Gadidae;Gadus;Gadus macrocephalus
FISHCARD_miu_075.1	Eukaryota;Chordata;Actinopteri;Osmeriformes;Osmeridae;Thaleichthys;Thaleichthys pacificus
FISHCARD_miu_076.1	Eukaryota;Chordata;Actinopteri;Perciformes;Hexagrammidae;Ophiodon;Ophiodon elongatus
FISHCARD_miu_077.1	Eukaryota;Chordata;Actinopteri;;Sciaenidae;Genyonemus;Genyonemus lineatus
FISHCARD_miu_078.1	Eukaryota;Chordata;Actinopteri;Zeiformes;Oreosomatidae;Allocyttus;Allocyttus folletti
FISHCARD_miu_079.1	Eukaryota;Chordata;Actinopteri;Gadiformes;Macrouridae;Coryphaenoides;Coryphaenoides acrolepis
FISHCARD_miu_080.1	Eukaryota;Chordata;Chondrichthyes;Pristiformes/Rhiniformes group;Rhinobatidae;Pseudobatos;Pseudobatos productus
FISHCARD_miu_081.1	Eukaryota;Chordata;Chondrichthyes;Myliobatiformes;Gymnuridae;Gymnura;Gymnura marmorata
FISHCARD_miu_082.1	Eukaryota;Chordata;Actinopteri;Perciformes;Zoarcidae;Bothrocara;Bothrocara molle
FISHCARD_miu_083.1	Eukaryota;Chordata;Actinopteri;;Malacanthidae;Caulolatilus;Caulolatilus princeps
FISHCARD_miu_084.1	Eukaryota;Chordata;Actinopteri;;Pomacentridae;Hypsypops;Hypsypops rubicundus
FISHCARD_miu_085.1	Eukaryota;Chordata;Actinopteri;Carangiformes;Echeneidae;Remorina;Remorina albescens
FISHCARD_miu_087.1	Eukaryota;Chordata;Actinopteri;Clupeiformes;Clupeidae;Sardinops;Sardinops sagax
FISHCARD_miu_088.1	Eukaryota;Chordata;Actinopteri;Scombriformes;Centrolophidae;Icichthys;Icichthys lockingtoni
FISHCARD_miu_089.1	Eukaryota;Chordata;Actinopteri;Pleuronectiformes;Pleuronectidae;Platichthys;Platichthys stellatus
FISHCARD_miu_090.1	Eukaryota;Chordata;Actinopteri;Beryciformes;Melamphaidae;Scopelogadus;Scopelogadus bispinosus
FISHCARD_miu_091.1	Eukaryota;Chordata;Actinopteri;Pleuronectiformes;Pleuronectidae;Pleuronichthys;Pleuronichthys coenosus
FISHCARD_miu_092.1	Eukaryota;Chordata;Actinopteri;Pleuronectiformes;Pleuronectidae;Pleuronichthys;Pleuronichthys guttulatus
FISHCARD_miu_093.1	Eukaryota;Chordata;Actinopteri;Stomiiformes;Phosichthyidae;Ichthyococcus;Ichthyococcus irregularis
FISHCARD_miu_094.1	Eukaryota;Chordata;Actinopteri;Argentiniformes;Bathylagidae;Bathylagoides;Bathylagoides wesethi
FISHCARD_miu_095.1	Eukaryota;Chordata;Actinopteri;Beryciformes;Melamphaidae;Melamphaes;Melamphaes lugubris
FISHCARD_miu_096.1	Eukaryota;Chordata;Actinopteri;Stomiiformes;Stomiidae;Tactostoma;Tactostoma macropus
FISHCARD_miu_097.1	Eukaryota;Chordata;Actinopteri;Stomiiformes;Stomiidae;Bathophilus;Bathophilus flemingi
FISHCARD_miu_098.1	Eukaryota;Chordata;Actinopteri;Stomiiformes;Sternoptychidae;Sternoptyx;Sternoptyx diaphana
FISHCARD_miu_100.1	Eukaryota;Chordata;Actinopteri;Stomiiformes;Stomiidae;Bathophilus;Bathophilus brevis
FISHCARD_miu_101.1	Eukaryota;Chordata;Actinopteri;Stomiiformes;Sternoptychidae;Danaphos;Danaphos oculatus
FISHCARD_miu_103.1	Eukaryota;Chordata;Actinopteri;Mugiliformes;Mugilidae;Mugil;Mugil setosus
FISHCARD_miu_104.1	Eukaryota;Chordata;Actinopteri;Myctophiformes;Myctophidae;Diaphus;Diaphus anderseni
FISHCARD_miu_105.1	Eukaryota;Chordata;Actinopteri;Aulopiformes;Scopelarchidae;Scopelarchus;Scopelarchus guentheri
FISHCARD_miu_106.1	Eukaryota;Chordata;Actinopteri;Carangiformes;Echeneidae;Remora;Remora osteochir
FISHCARD_miu_107.1	Eukaryota;Chordata;Actinopteri;Scombriformes;Gempylidae;Diplospinus;Diplospinus multistriatus
FISHCARD_miu_108.1	Eukaryota;Chordata;Actinopteri;Acanthuriformes;Luvaridae;Luvarus;Luvarus imperialis
FISHCARD_miu_109.1	Eukaryota;Chordata;Actinopteri;Syngnathiformes;Callionymidae;Synchiropus;Synchiropus atrilabiatus
FISHCARD_miu_110.1	Eukaryota;Chordata;Actinopteri;Perciformes;Agonidae;Chesnonia;Chesnonia verrucosa
FISHCARD_miu_111.1	Eukaryota;Chordata;Actinopteri;Perciformes;Cottidae;Icelinus;Icelinus quadriseriatus
FISHCARD_miu_112.1	Eukaryota;Chordata;Actinopteri;Perciformes;Cottidae;Artedius;Artedius notospilotus
FISHCARD_miu_113.1	Eukaryota;Chordata;Actinopteri;Blenniiformes;Labrisomidae;Neoclinus;Neoclinus blanchardi
FISHCARD_miu_114.1	Eukaryota;Chordata;Actinopteri;Gadiformes;Gadidae;Microgadus;Microgadus proximus
FISHCARD_miu_116.1	Eukaryota;Chordata;Actinopteri;Stomiiformes;Stomiidae;Eustomias;Eustomias sp.
FISHCARD_miu_118.1	Eukaryota;Chordata;Actinopteri;Argentiniformes;Opisthoproctidae;Macropinna;Macropinna microstoma
FISHCARD_miu_119.1	Eukaryota;Chordata;Actinopteri;Stomiiformes;Stomiidae;Opostomias;Opostomias mitsuii
FISHCARD_miu_120.1	Eukaryota;Chordata;Actinopteri;Stomiiformes;Stomiidae;Photonectes;Photonectes margarita
FISHCARD_miu_121.1	Eukaryota;Chordata;Actinopteri;Beloniformes;Belonidae;Cololabis;Cololabis saira
FISHCARD_miu_122.1	Eukaryota;Chordata;Actinopteri;Beloniformes;Exocoetidae;Hirundichthys;Hirundichthys rondeletii
FISHCARD_miu_123.1	Eukaryota;Chordata;Actinopteri;Beloniformes;Hemiramphidae;Hyporhamphus;Hyporhamphus naos
FISHCARD_miu_124.1	Eukaryota;Chordata;Actinopteri;Myctophiformes;Myctophidae;Loweina;Loweina rara
FISHCARD_miu_125.1	Eukaryota;Chordata;Actinopteri;Myctophiformes;Myctophidae;Diogenichthys;Diogenichthys atlanticus
FISHCARD_miu_126.1	Eukaryota;Chordata;Actinopteri;Myctophiformes;Myctophidae;Electrona;Electrona risso
FISHCARD_miu_127.1	Eukaryota;Chordata;Actinopteri;Myctophiformes;Myctophidae;Nannobrachium;Nannobrachium bristori
FISHCARD_miu_128.1	Eukaryota;Chordata;Actinopteri;Myctophiformes;Myctophidae;Nannobrachium;Nannobrachium hawaiiensis
FISHCARD_miu_129.1	Eukaryota;Chordata;Actinopteri;Myctophiformes;Myctophidae;Protomyctophum;Protomyctophum thompsoni
FISHCARD_miu_130.1	Eukaryota;Chordata;Actinopteri;Aulopiformes;Scopelarchidae;Rosenblattichthys;Rosenblattichthys volucris
FISHCARD_miu_131.1	Eukaryota;Chordata;Actinopteri;Perciformes;Sebastidae;Sebastes;Sebastes lentiginosus
FISHCARD_miu_132.1	Eukaryota;Chordata;Actinopteri;Aulopiformes;Scopelarchidae;Scopelarchus;Scopelarchus analis
FISHCARD_miu_133.1	Eukaryota;Chordata;Actinopteri;Aulopiformes;Paralepididae;Sudis;Sudis atrox
FISHCARD_miu_134.1	Eukaryota;Chordata;Actinopteri;Anguilliformes;Cyematidae;Cyema;Cyema atrum
FISHCARD_miu_135.1	Eukaryota;Chordata;Actinopteri;Lampriformes;Trachipteridae;Zu;Zu cristatus
FISHCARD_miu_136.1	Eukaryota;Chordata;Actinopteri;Trachichthyiformes;Anoplogasteridae;Anoplogaster;Anoplogaster cornuta
FISHCARD_miu_137.1	Eukaryota;Chordata;Actinopteri;Beryciformes;Melamphaidae;Melamphaes;Melamphaes suborbitalis
FISHCARD_miu_138.1	Eukaryota;Chordata;Actinopteri;Atheriniformes;Atherinopsidae;Atherinops;Atherinops affinis
FISHCARD_miu_139.1	Eukaryota;Chordata;Actinopteri;Carangiformes;Carangidae;Caranx;Caranx caninus
FISHCARD_miu_140.1	Eukaryota;Chordata;Actinopteri;Scombriformes;Bramidae;Pteraclis;Pteraclis aesticola
FISHCARD_miu_141.1	Eukaryota;Chordata;Actinopteri;;Embiotocidae;Brachyistius;Brachyistius frenatus
FISHCARD_miu_142.1	Eukaryota;Chordata;Actinopteri;;Embiotocidae;Cymatogaster;Cymatogaster aggregata
FISHCARD_miu_143.1	Eukaryota;Chordata;Chondrichthyes;Myliobatiformes;Dasyatidae;Pteroplatytrygon;Pteroplatytrygon violacea
FISHCARD_miu_144.1	Eukaryota;Chordata;Actinopteri;Clupeiformes;Clupeidae;Dorosoma;Dorosoma petenense
FISHCARD_miu_145.1	Eukaryota;Chordata;Actinopteri;Stomiiformes;Diplophidae;Diplophos;Diplophos taenia
FISHCARD_miu_146.1	Eukaryota;Chordata;Actinopteri;Chaetodontiformes;Chaetodontidae;Prognathodes;Prognathodes falcifer
FISHCARD_miu_147.1	Eukaryota;Chordata;Actinopteri;Tetraodontiformes;Balistidae;Melichthys;Melichthys niger
FISHCARD_miu_148.1	Eukaryota;Chordata;Actinopteri;Tetraodontiformes;Molidae;Mola;Mola mola
FISHCARD_miu_149.1	Eukaryota;Chordata;Actinopteri;Tetraodontiformes;Molidae;Ranzania;Ranzania laevis
FISHCARD_miu_150.1	Eukaryota;Chordata;Actinopteri;Syngnathiformes;Mullidae;Mulloidichthys;Mulloidichthys dentatus
FISHCARD_miu_151.1	Eukaryota;Chordata;Actinopteri;Mugiliformes;Mugilidae;Mugil;Mugil cephalus
FISHCARD_miu_152.1	Eukaryota;Chordata;Actinopteri;Gerreiformes;Gerreidae;Eucinostomus;Eucinostomus gracilis
FISHCARD_miu_153.1	Eukaryota;Chordata;Actinopteri;Carangiformes;Carangidae;Caranx;Caranx sexfasciatus
FISHCARD_miu_154.1	Eukaryota;Chordata;Actinopteri;Scombriformes;Scombridae;Auxis;Auxis rochei
FISHCARD_miu_155.1	Eukaryota;Chordata;Actinopteri;Scombriformes;Scombridae;Auxis;Auxis thazard
FISHCARD_miu_156.1	Eukaryota;Chordata;Actinopteri;Scombriformes;Scombridae;Katsuwonus;Katsuwonus pelamis
FISHCARD_miu_157.1	Eukaryota;Chordata;Actinopteri;Scombriformes;Gempylidae;Lepidocybium;Lepidocybium flavobrunneum
FISHCARD_miu_158.1	Eukaryota;Chordata;Actinopteri;Scombriformes;Scombridae;Scomberomorus;Scomberomorus concolor
FISHCARD_miu_159.1	Eukaryota;Chordata;Actinopteri;Scombriformes;Trichiuridae;Trichiurus;Trichiurus nitens
FISHCARD_miu_160.1	Eukaryota;Chordata;Actinopteri;;Embiotocidae;Amphistichus;Amphistichus argenteus
FISHCARD_miu_161.1	Eukaryota;Chordata;Actinopteri;;Embiotocidae;Amphistichus;Amphistichus koelzi
FISHCARD_miu_162.1	Eukaryota;Chordata;Actinopteri;;Embiotocidae;Hyperprosopon;Hyperprosopon ellipticum
FISHCARD_miu_163.1	Eukaryota;Chordata;Actinopteri;;Embiotocidae;Zalembius;Zalembius rosaceus
FISHCARD_miu_164.1	Eukaryota;Chordata;Actinopteri;;Embiotocidae;Rhacochilus;Rhacochilus toxotes
FISHCARD_miu_165.1	Eukaryota;Chordata;Actinopteri;Labriformes;Labridae;Halichoeres;Halichoeres semicinctus
FISHCARD_miu_166.1	Eukaryota;Chordata;Actinopteri;Ephippiformes;Ephippidae;Chaetodipterus;Chaetodipterus zonatus
FISHCARD_miu_167.1	Eukaryota;Chordata;Actinopteri;Centrarchiformes;Kyphosidae;Kyphosus;Kyphosus ocyurus
FISHCARD_miu_168.1	Eukaryota;Chordata;Actinopteri;Perciformes;Sebastidae;Sebastes;Sebastes constellatus
FISHCARD_miu_169.1	Eukaryota;Chordata;Actinopteri;Perciformes;Sebastidae;Sebastes;Sebastes eos
FISHCARD_miu_170.1	Eukaryota;Chordata;Actinopteri;Perciformes;Sebastidae;Sebastes;Sebastes goodei
FISHCARD_miu_171.1	Eukaryota;Chordata;Actinopteri;Perciformes;Sebastidae;Sebastes;Sebastes macdonaldi
FISHCARD_miu_172.1	Eukaryota;Chordata;Actinopteri;Perciformes;Sebastidae;Sebastes;Sebastes melanosema
FISHCARD_miu_173.1	Eukaryota;Chordata;Actinopteri;Perciformes;Sebastidae;Sebastes;Sebastes rosenblatti
FISHCARD_miu_174.1	Eukaryota;Chordata;Actinopteri;Perciformes;Sebastidae;Sebastes;Sebastes ruberrimus
FISHCARD_miu_175.1	Eukaryota;Chordata;Actinopteri;Perciformes;Anoplopomatidae;Erilepis;Erilepis zonifer
FISHCARD_miu_176.1	Eukaryota;Chordata;Actinopteri;Perciformes;Cottidae;Leiocottus;Leiocottus hirundo
FISHCARD_miu_177.1	Eukaryota;Chordata;Actinopteri;Perciformes;Agonidae;Agonomalus;Agonomalus mozinoi
FISHCARD_miu_178.1	Eukaryota;Chordata;Actinopteri;Perciformes;Agonidae;Xeneretmus;Xeneretmus ritteri
FISHCARD_miu_179.1	Eukaryota;Chordata;Actinopteri;Perciformes;Cryptacanthodidae;Cryptacanthodes;Cryptacanthodes aleutensis
FISHCARD_miu_180.1	Eukaryota;Chordata;Actinopteri;Perciformes;Zoarcidae;Melanostigma;Melanostigma pammelas
FISHCARD_miu_181.1	Eukaryota;Chordata;Actinopteri;Perciformes;Stichaeidae;Xiphister;Xiphister mucosus
FISHCARD_miu_182.1	Eukaryota;Chordata;Actinopteri;Gadiformes;Macrouridae;Albatrossia;Albatrossia pectoralis
FISHCARD_miu_183.1	Eukaryota;Chordata;Actinopteri;Pleuronectiformes;Pleuronectidae;Atheresthes;Atheresthes stomias
FISHCARD_miu_184.1	Eukaryota;Chordata;Actinopteri;Lophiiformes;Antennariidae;Fowlerichthys;Fowlerichthys avalonis
FISHCARD_miu_185.1	Eukaryota;Chordata;Actinopteri;Perciformes;Sebastidae;Sebastes;Sebastes wilsoni
FISHCARD_miu_186.1	Eukaryota;Chordata;Actinopteri;Perciformes;Hexagrammidae;Hexagrammos;Hexagrammos decagrammus
FISHCARD_miu_187.1	Eukaryota;Chordata;Actinopteri;Blenniiformes;Gobiesocidae;Rimicola;Rimicola muscarum
FISHCARD_miu_188.1	Eukaryota;Chordata;Actinopteri;Ophidiiformes;Bythitidae;Brosmophycis;Brosmophycis marginata
FISHCARD_miu_189.1	Eukaryota;Chordata;Actinopteri;;Embiotocidae;Embiotoca;Embiotoca jacksoni
FISHCARD_miu_190.1	Eukaryota;Chordata;Actinopteri;Blenniiformes;Clinidae;Gibbonsia;Gibbonsia metzi
FISHCARD_miu_191.1	Eukaryota;Chordata;Actinopteri;Perciformes;Sebastidae;Sebastes;Sebastes borealis
FISHCARD_miu_192.1	Eukaryota;Chordata;Actinopteri;Perciformes;Sebastidae;Sebastes;Sebastes diploproa
FISHCARD_miu_193.1	Eukaryota;Chordata;Actinopteri;Perciformes;Sebastidae;Sebastes;Sebastes flavidus
FISHCARD_miu_194.1	Eukaryota;Chordata;Actinopteri;Perciformes;Sebastidae;Sebastes;Sebastes phillipsi
FISHCARD_miu_195.1	Eukaryota;Chordata;Actinopteri;Perciformes;Sebastidae;Sebastes;Sebastes proriger
FISHCARD_miu_196.1	Eukaryota;Chordata;Actinopteri;Perciformes;Sebastidae;Sebastes;Sebastes rufus
FISHCARD_miu_197.1	Eukaryota;Chordata;Actinopteri;Perciformes;Sebastidae;Sebastes;Sebastes serriceps
FISHCARD_miu_198.1	Eukaryota;Chordata;Actinopteri;Acipenseriformes;Acipenseridae;Acipenser;Acipenser transmontanus
FISHCARD_miu_199.1	Eukaryota;Chordata;Actinopteri;Albuliformes;Albulidae;Albula;Albula pacificus
FISHCARD_miu_200.1	Eukaryota;Chordata;Actinopteri;Lampriformes;Lophotidae;Lophotus;Lophotus capellei
FISHCARD_miu_201.1	Eukaryota;Chordata;Actinopteri;Perciformes;Serranidae;Hyporthodus;Hyporthodus niphobles
FISHCARD_miu_202.1	Eukaryota;Chordata;Actinopteri;Atheriniformes;Atherinopsidae;Atherinopsis;Atherinopsis californiensis
FISHCARD_miu_203.1	Eukaryota;Chordata;Actinopteri;Scombriformes;Nomeidae;Nomeus;Nomeus gronovii
FISHCARD_miu_204.1	Eukaryota;Chordata;Actinopteri;Scombriformes;Scombridae;Thunnus;Thunnus alalunga
FISHCARD_miu_205.1	Eukaryota;Chordata;Actinopteri;Myctophiformes;Myctophidae;Diaphus;Diaphus theta
FISHCARD_miu_206.1	Eukaryota;Chordata;Actinopteri;Perciformes;Sebastidae;Sebastolobus;Sebastolobus alascanus
FISHCARD_miu_207.1	Eukaryota;Chordata;Actinopteri;Lophiiformes;Oneirodidae;Oneirodes;Oneirodes eschrichtii
FISHCARD_miu_208.1	Eukaryota;Chordata;Chondrichthyes;Heterodontiformes;Heterodontidae;Heterodontus;Heterodontus francisci
FISHCARD_miu_209.1	Eukaryota;Chordata;Chondrichthyes;Lamniformes;Alopiidae;Isurus;Isurus oxyrinchus
FISHCARD_miu_210.1	Eukaryota;Chordata;Chondrichthyes;Carcharhiniformes;Carcharhinidae;Rhizoprionodon;Rhizoprionodon longurio
FISHCARD_miu_211.1	Eukaryota;Chordata;Actinopteri;Beloniformes;Belonidae;Strongylura;Strongylura exilis
FISHCARD_miu_212.1	Eukaryota;Chordata;Actinopteri;Anguilliformes;Congridae;Gnathophis;Ariosoma gilberti
FISHCARD_miu_213.1	Eukaryota;Chordata;Actinopteri;Labriformes;Labridae;Nicholsina;Nicholsina denticulata
FISHCARD_miu_214.1	Eukaryota;Chordata;Chondrichthyes;Lamniformes;Alopiidae;Lamna;Lamna ditropis
FISHCARD_miu_215.1	Eukaryota;Chordata;Actinopteri;Labriformes;Labridae;Decodon;Decodon melasma
FISHCARD_miu_216.1	Eukaryota;Chordata;Actinopteri;Pleuronectiformes;Pleuronectidae;Eopsetta;Eopsetta jordani
FISHCARD_miu_217.1	Eukaryota;Chordata;Actinopteri;Argentiniformes;Argentinidae;Argentina;Argentina sialis
FISHCARD_miu_218.1	Eukaryota;Chordata;Actinopteri;Stomiiformes;Sternoptychidae;Valenciennellus;Valenciennellus tripunctulatus
FISHCARD_miu_219.1	Eukaryota;Chordata;Actinopteri;Beryciformes;Melamphaidae;Melamphaes;Melamphaes acanthomus
FISHCARD_miu_220.1	Eukaryota;Chordata;Actinopteri;Lutjaniformes;Lutjanidae;Lutjanus;Lutjanus peru
FISHCARD_miu_221.1	Eukaryota;Chordata;Actinopteri;Lampriformes;Lampridae;Lampris;Lampris guttatus
FISHCARD_miu_222.1	Eukaryota;Chordata;Chondrichthyes;Squaliformes;Dalatiidae;Euprotomicrus;Euprotomicrus bispinatus
FISHCARD_miu_224.1	Eukaryota;Chordata;Actinopteri;Argentiniformes;Microstomatidae;Microstoma;Microstoma microstoma
FISHCARD_miu_225.1	Eukaryota;Chordata;Actinopteri;Beryciformes;Melamphaidae;Melamphaes;Melamphaes laeviceps
FISHCARD_miu_226.1	Eukaryota;Chordata;Actinopteri;Scombriformes;Scombridae;Thunnus;Thunnus obesus
FISHCARD_miu_227.1	Eukaryota;Chordata;Actinopteri;Perciformes;Sebastidae;Sebastes;Sebastes reedi
FISHCARD_miu_228.1	Eukaryota;Chordata;Actinopteri;Perciformes;Agonidae;Stellerina;Stellerina xyosterna
FISHCARD_miu_229.1	Eukaryota;Chordata;Actinopteri;Perciformes;Agonidae;Xeneretmus;Xeneretmus leiops
FISHCARD_miu_230.1	Eukaryota;Chordata;Actinopteri;Anguilliformes;Congridae;Congriscus;Congriscus megastomus
FISHCARD_miu_231.1	Eukaryota;Chordata;Actinopteri;Argentiniformes;Bathylagidae;Leuroglossus;Leuroglossus stilbius
FISHCARD_miu_232.1	Eukaryota;Chordata;Actinopteri;Argentiniformes;Bathylagidae;Pseudobathylagus;Pseudobathylagus milleri
FISHCARD_miu_233.1	Eukaryota;Chordata;Actinopteri;Perciformes;Bathymasteridae;Rathbunella;Rathbunella hypoplecta
FISHCARD_miu_235.1	Eukaryota;Chordata;Actinopteri;Batrachoidiformes;Batrachoididae;Porichthys;Porichthys notatus
FISHCARD_miu_236.1	Eukaryota;Chordata;Actinopteri;Scombriformes;Bramidae;Taractes;Taractes asper
FISHCARD_miu_237.1	Eukaryota;Chordata;Actinopteri;Syngnathiformes;Callionymidae;Synchiropus;Synchiropus atrilabiatus
FISHCARD_miu_238.1	Eukaryota;Chordata;Actinopteri;Carangiformes;Carangidae;Caranx;Caranx vinctus
FISHCARD_miu_239.1	Eukaryota;Chordata;Actinopteri;Carangiformes;Carangidae;Selene;Selene brevoortii
FISHCARD_miu_240.1	Eukaryota;Chordata;Actinopteri;Carangiformes;Carangidae;Seriola;Seriola dorsalis
FISHCARD_miu_241.1	Eukaryota;Chordata;Actinopteri;Blenniiformes;Chaenopsidae;Chaenopsis;Chaenopsis alepidota
FISHCARD_miu_242.1	Eukaryota;Chordata;Actinopteri;Stomiiformes;Stomiidae;Chauliodus;Chauliodus macouni
FISHCARD_miu_243.1	Eukaryota;Chordata;Actinopteri;Blenniiformes;Clinidae;Gibbonsia;Gibbonsia elegans
FISHCARD_miu_244.1	Eukaryota;Chordata;Actinopteri;Blenniiformes;Clinidae;Heterostichus;Heterostichus rostratus
FISHCARD_miu_245.1	Eukaryota;Chordata;Actinopteri;Clupeiformes;Clupeidae;Opisthonema;Opisthonema libertate
FISHCARD_miu_246.1	Eukaryota;Chordata;Actinopteri;Perciformes;Cottidae;Artedius;Artedius corallinus
FISHCARD_miu_248.1	Eukaryota;Chordata;Actinopteri;Perciformes;Cottidae;Artedius;Artedius notospilotus
FISHCARD_miu_249.1	Eukaryota;Chordata;Actinopteri;Perciformes;Cottidae;Chitonotus;Chitonotus pugetensis
FISHCARD_miu_250.1	Eukaryota;Chordata;Actinopteri;Perciformes;Cottidae;Clinocottus;Clinocottus analis
FISHCARD_miu_251.1	Eukaryota;Chordata;Actinopteri;Perciformes;Cottidae;Icelinus;Icelinus burchami
FISHCARD_miu_252.1	Eukaryota;Chordata;Actinopteri;Perciformes;Cottidae;Icelinus;Icelinus cavifrons
FISHCARD_miu_253.1	Eukaryota;Chordata;Actinopteri;Perciformes;Cottidae;Icelinus;Icelinus filamentosus
FISHCARD_miu_254.1	Eukaryota;Chordata;Actinopteri;Perciformes;Cottidae;Icelinus;Icelinus oculatus
FISHCARD_miu_255.1	Eukaryota;Chordata;Actinopteri;Perciformes;Cottidae;Leptocottus;Leptocottus armatus
FISHCARD_miu_256.1	Eukaryota;Chordata;Actinopteri;Perciformes;Cottidae;Orthonopias;Orthonopias triacis
FISHCARD_miu_257.1	Eukaryota;Chordata;Actinopteri;Perciformes;Cottidae;Scorpaenichthys;Scorpaenichthys marmoratus
FISHCARD_miu_258.1	Eukaryota;Chordata;Actinopteri;Perciformes;Liparidae;Careproctus;Careproctus melanurus
FISHCARD_miu_259.1	Eukaryota;Chordata;Actinopteri;Perciformes;Liparidae;Liparis;Liparis mucosus
FISHCARD_miu_260.1	Eukaryota;Chordata;Actinopteri;Pleuronectiformes;Cynoglossidae;Symphurus;Symphurus atricaudus
FISHCARD_miu_261.1	Eukaryota;Chordata;Actinopteri;Carangiformes;Echeneidae;Remora;Remora remora
FISHCARD_miu_262.1	Eukaryota;Chordata;Actinopteri;Elopiformes;Elopidae;Elops;Elops affinis
FISHCARD_miu_263.1	Eukaryota;Chordata;Actinopteri;;Embiotocidae;Amphistichus;Amphistichus rhodoterus
FISHCARD_miu_264.1	Eukaryota;Chordata;Actinopteri;;Embiotocidae;Embiotoca;Embiotoca lateralis
FISHCARD_miu_265.1	Eukaryota;Chordata;Actinopteri;;Embiotocidae;Cymatogaster;Cymatogaster aggregata
FISHCARD_miu_266.1	Eukaryota;Chordata;Actinopteri;;Embiotocidae;Phanerodon;Phanerodon atripes
FISHCARD_miu_267.1	Eukaryota;Chordata;Actinopteri;Clupeiformes;Engraulidae;Anchoa;Anchoa compressa
FISHCARD_miu_268.1	Eukaryota;Chordata;Actinopteri;Clupeiformes;Engraulidae;Anchoa;Anchoa delicatissima
FISHCARD_miu_269.1	Eukaryota;Chordata;Actinopteri;Beloniformes;Exocoetidae;Cheilopogon;Cheilopogon pinnatibarbatus
FISHCARD_miu_270.1	Eukaryota;Chordata;Actinopteri;Cyprinodontiformes;Fundulidae;Fundulus;Fundulus parvipinnis
FISHCARD_miu_271.1	Eukaryota;Chordata;Actinopteri;Scombriformes;Gempylidae;Ruvettus;Ruvettus pretiosus
FISHCARD_miu_272.1	Eukaryota;Chordata;Actinopteri;Lophiiformes;Gigantactinidae;Gigantactis;Gigantactis vanhoeffeni
FISHCARD_miu_273.1	Eukaryota;Chordata;Actinopteri;Gobiiformes;Gobiidae;Acanthogobius;Acanthogobius flavimanus
FISHCARD_miu_275.1	Eukaryota;Chordata;Actinopteri;Gobiiformes;Gobiidae;Rhinogobiops;Rhinogobiops nicholsii
FISHCARD_miu_276.1	Eukaryota;Chordata;Actinopteri;Gobiiformes;Gobiidae;Ctenogobius;Ctenogobius sagittula
FISHCARD_miu_277.1	Eukaryota;Chordata;Actinopteri;Gobiiformes;Gobiidae;Lethops;Lethops connectens
FISHCARD_miu_278.1	Eukaryota;Chordata;Actinopteri;Gobiiformes;Gobiidae;Quietula;Quietula y-cauda
FISHCARD_miu_279.1	Eukaryota;Chordata;Actinopteri;Gobiiformes;Gobiidae;Typhlogobius;Typhlogobius californiensis
FISHCARD_miu_280.1	Eukaryota;Chordata;Actinopteri;Stomiiformes;Gonostomatidae;Cyclothone;Cyclothone acclinidens
FISHCARD_miu_281.1	Eukaryota;Chordata;Actinopteri;Stomiiformes;Gonostomatidae;Cyclothone;Cyclothone pseudopallida
FISHCARD_miu_282.1	Eukaryota;Chordata;Actinopteri;Lutjaniformes;Haemulidae;Anisotremus;Anisotremus davidsonii
FISHCARD_miu_283.1	Eukaryota;Chordata;Actinopteri;Lutjaniformes;Haemulidae;Brachygenys;Brachygenys californiensis
FISHCARD_miu_284.1	Eukaryota;Chordata;Actinopteri;Perciformes;Hexagrammidae;Hexagrammos;Hexagrammos decagrammus
FISHCARD_miu_285.1	Eukaryota;Chordata;Actinopteri;Perciformes;Hexagrammidae;Oxylebius;Oxylebius pictus
FISHCARD_miu_286.1	Eukaryota;Chordata;Actinopteri;Stomiiformes;Stomiidae;Idiacanthus;Idiacanthus antrostomus
FISHCARD_miu_287.1	Eukaryota;Chordata;Actinopteri;Istiophoriformes;Istiophoridae;Istiophorus;Istiophorus platypterus
FISHCARD_miu_288.1	Eukaryota;Chordata;Actinopteri;Istiophoriformes;Istiophoridae;Tetrapturus;Tetrapturus angustirostris
FISHCARD_miu_289.1	Eukaryota;Chordata;Actinopteri;Centrarchiformes;Kyphosidae;Girella;Girella nigricans
FISHCARD_miu_290.1	Eukaryota;Chordata;Actinopteri;Centrarchiformes;Kyphosidae;Kyphosus;Kyphosus azureus
FISHCARD_miu_291.1	Eukaryota;Chordata;Actinopteri;Centrarchiformes;Kyphosidae;Medialuna;Medialuna californiensis
FISHCARD_miu_292.1	Eukaryota;Chordata;Actinopteri;Labriformes;Labridae;Halichoeres;Halichoeres californica
FISHCARD_miu_293.1	Eukaryota;Chordata;Actinopteri;Labriformes;Labridae;Bodianus;Bodianus pulcher
FISHCARD_miu_294.1	Eukaryota;Chordata;Actinopteri;Blenniiformes;Labrisomidae;Alloclinus;Alloclinus holderi
FISHCARD_miu_295.1	Eukaryota;Chordata;Actinopteri;Lobotiformes;Lobotidae;Lobotes;Lobotes pacificus
FISHCARD_miu_296.1	Eukaryota;Chordata;Actinopteri;Lophiiformes;Lophiidae;Lophiodes;Lophiodes caulinaris
FISHCARD_miu_297.1	Eukaryota;Chordata;Actinopteri;Lophiiformes;Lophiidae;Lophiodes;Lophiodes spilurus
FISHCARD_miu_298.1	Eukaryota;Chordata;Actinopteri;Lampriformes;Lophotidae;Lophotus;Lophotus lacepede
FISHCARD_miu_299.1	Eukaryota;Chordata;Actinopteri;Lutjaniformes;Lutjanidae;Lutjanus;Lutjanus argentiventris
FISHCARD_miu_300.1	Eukaryota;Chordata;Actinopteri;Gadiformes;Macrouridae;Coryphaenoides;Coryphaenoides filifer
FISHCARD_miu_301.1	Eukaryota;Chordata;Actinopteri;;Malacanthidae;Caulolatilus;Caulolatilus princeps
FISHCARD_miu_302.1	Eukaryota;Chordata;Actinopteri;Stomiiformes;Stomiidae;Aristostomias;Aristostomias scintillans
FISHCARD_miu_303.1	Eukaryota;Chordata;Actinopteri;Gadiformes;Moridae;Halargyreus;Halargyreus johnsonii
FISHCARD_miu_304.1	Eukaryota;Chordata;Actinopteri;Syngnathiformes;Mullidae;Pseudupeneus;Pseudupeneus grandisquamis
FISHCARD_miu_305.1	Eukaryota;Chordata;Actinopteri;Myctophiformes;Myctophidae;Lampadena;Lampadena urophaos
FISHCARD_miu_306.1	Eukaryota;Chordata;Actinopteri;Myctophiformes;Myctophidae;Lampanyctus;Lampanyctus tenuiformis
FISHCARD_miu_307.1	Eukaryota;Chordata;Actinopteri;Myctophiformes;Myctophidae;Nannobrachium;Nannobrachium ritteri
FISHCARD_miu_308.1	Eukaryota;Chordata;Actinopteri;Myctophiformes;Myctophidae;Notolychnus;Notolychnus valdiviae
FISHCARD_miu_309.1	Eukaryota;Chordata;Actinopteri;Myctophiformes;Myctophidae;Symbolophorus;Symbolophorus californiensis
FISHCARD_miu_310.1	Eukaryota;Chordata;Actinopteri;Myctophiformes;Myctophidae;Symbolophorus;Symbolophorus evermanni
FISHCARD_miu_311.1	Eukaryota;Chordata;Actinopteri;Myctophiformes;Myctophidae;Taaningichthys;Taaningichthys bathyphilus
FISHCARD_miu_312.1	Eukaryota;Chordata;Actinopteri;Myctophiformes;Myctophidae;Triphoturus;Triphoturus mexicanus
FISHCARD_miu_313.1	Eukaryota;Chordata;Chondrichthyes;Myliobatiformes;Myliobatidae;Myliobatis;Myliobatis californica
FISHCARD_miu_314.1	Eukaryota;Chordata;Myxini;Myxiniformes;Myxinidae;Eptatretus;Eptatretus stoutii
FISHCARD_miu_315.1	Eukaryota;Chordata;Actinopteri;Anguilliformes;Nemichthyidae;Avocettina;Avocettina infans
FISHCARD_miu_316.1	Eukaryota;Chordata;Actinopteri;Anguilliformes;Nemichthyidae;Nemichthys;Nemichthys scolopaceus
FISHCARD_miu_317.1	Eukaryota;Chordata;Actinopteri;Anguilliformes;Nettastomatidae;Facciolella;Facciolella gilbertii
FISHCARD_miu_318.1	Eukaryota;Chordata;Actinopteri;Scombriformes;Nomeidae;Cubiceps;Cubiceps baxteri
FISHCARD_miu_319.1	Eukaryota;Chordata;Actinopteri;Scombriformes;Nomeidae;Psenes;Psenes pellucidus
FISHCARD_miu_320.1	Eukaryota;Chordata;Actinopteri;Aulopiformes;Notosudidae;Scopelosaurus;Scopelosaurus harryi
FISHCARD_miu_321.1	Eukaryota;Chordata;Actinopteri;Anguilliformes;Ophichthidae;Myrophis;Myrophis vafer
FISHCARD_miu_322.1	Eukaryota;Chordata;Actinopteri;Anguilliformes;Ophichthidae;Ophichthus;Ophichthus zophochir
FISHCARD_miu_323.1	Eukaryota;Chordata;Actinopteri;Tetraodontiformes;Ostraciidae;Lactoria;Lactoria diaphana
FISHCARD_miu_324.1	Eukaryota;Chordata;Actinopteri;Aulopiformes;Paralepididae;Lestidiops;Lestidiops ringens
FISHCARD_miu_325.1	Eukaryota;Chordata;Actinopteri;Aulopiformes;Paralepididae;Macroparalepis;Macroparalepis johnfitchi
FISHCARD_miu_326.1	Eukaryota;Chordata;Actinopteri;Aulopiformes;Paralepididae;Magnisudis;Magnisudis atlantica
FISHCARD_miu_327.1	Eukaryota;Chordata;Actinopteri;Aulopiformes;Paralepididae;Stemonosudis;Stemonosudis macrura
FISHCARD_miu_328.1	Eukaryota;Chordata;Actinopteri;Pleuronectiformes;Paralichthyidae;Citharichthys;Citharichthys sordidus
FISHCARD_miu_329.1	Eukaryota;Chordata;Actinopteri;Pleuronectiformes;Paralichthyidae;Citharichthys;Citharichthys stigmaeus
FISHCARD_miu_330.1	Eukaryota;Chordata;Actinopteri;Pleuronectiformes;Paralichthyidae;Citharichthys;Citharichthys xanthostigma
FISHCARD_miu_331.1	Eukaryota;Chordata;Actinopteri;Pleuronectiformes;Paralichthyidae;Paralichthys;Paralichthys californicus
FISHCARD_miu_332.1	Eukaryota;Chordata;Actinopteri;Pleuronectiformes;Paralichthyidae;Xystreurys;Xystreurys liolepis
FISHCARD_miu_333.1	Eukaryota;Chordata;Actinopteri;Pempheriformes;Pentacerotidae;Pentaceros;Pentaceros wheeleri
FISHCARD_miu_334.1	Eukaryota;Chordata;Actinopteri;Perciformes;Pholidae;Pholis;Pholis ornata
FISHCARD_miu_335.1	Eukaryota;Chordata;Actinopteri;Alepocephaliformes;Platytroctidae;Sagamichthys;Sagamichthys abei
FISHCARD_miu_336.1	Eukaryota;Chordata;Actinopteri;Pleuronectiformes;Pleuronectidae;Clidoderma;Clidoderma asperrimum
FISHCARD_miu_337.1	Eukaryota;Chordata;Actinopteri;Pleuronectiformes;Pleuronectidae;Embassichthys;Embassichthys bathybius
FISHCARD_miu_338.1	Eukaryota;Chordata;Actinopteri;Pleuronectiformes;Pleuronectidae;Hippoglossoides;Hippoglossoides elassodon
FISHCARD_miu_339.1	Eukaryota;Chordata;Actinopteri;Pleuronectiformes;Pleuronectidae;Pleuronichthys;Pleuronichthys decurrens
FISHCARD_miu_340.1	Eukaryota;Chordata;Actinopteri;Pleuronectiformes;Pleuronectidae;Pleuronichthys;Pleuronichthys ritteri
FISHCARD_miu_341.1	Eukaryota;Chordata;Actinopteri;Pleuronectiformes;Pleuronectidae;Pleuronichthys;Pleuronichthys verticalis
FISHCARD_miu_342.1	Eukaryota;Chordata;Actinopteri;;Polynemidae;Polydactylus;Polydactylus approximans
FISHCARD_miu_343.1	Eukaryota;Chordata;Actinopteri;Pempheriformes;Polyprionidae;Stereolepis;Stereolepis gigas
FISHCARD_miu_344.1	Eukaryota;Chordata;Actinopteri;;Pomacanthidae;Pomacanthus;Pomacanthus zonipectus
FISHCARD_miu_345.1	Eukaryota;Chordata;Actinopteri;;Pomacentridae;Azurina;Azurina hirundo
FISHCARD_miu_346.1	Eukaryota;Chordata;Actinopteri;;Pomacentridae;Chromis;Chromis alta
FISHCARD_miu_347.1	Eukaryota;Chordata;Actinopteri;;Pomacentridae;Chromis;Chromis punctipinnis
FISHCARD_miu_348.1	Eukaryota;Chordata;Actinopteri;Priacanthiformes;Priacanthidae;Pristigenys;Pristigenys serrula
FISHCARD_miu_349.1	Eukaryota;Chordata;Actinopteri;Perciformes;Psychrolutidae;Psychrolutes;Psychrolutes phrictus
FISHCARD_miu_350.1	Eukaryota;Chordata;Actinopteri;Lampriformes;Regalecidae;Regalecus;Regalecus glesne
FISHCARD_miu_351.1	Eukaryota;Chordata;Actinopteri;Perciformes;Rhamphocottidae;Rhamphocottus;Rhamphocottus richardsonii
FISHCARD_miu_352.1	Eukaryota;Chordata;Actinopteri;;Sciaenidae;Cheilotrema;Cheilotrema saturnum
FISHCARD_miu_353.1	Eukaryota;Chordata;Actinopteri;;Sciaenidae;Cynoscion;Cynoscion parvipinnis
FISHCARD_miu_354.1	Eukaryota;Chordata;Actinopteri;;Sciaenidae;Menticirrhus;Menticirrhus undulatus
FISHCARD_miu_355.1	Eukaryota;Chordata;Actinopteri;;Sciaenidae;Seriphus;Seriphus politus
FISHCARD_miu_356.1	Eukaryota;Chordata;Actinopteri;;Sciaenidae;Umbrina;Umbrina roncador
FISHCARD_miu_357.1	Eukaryota;Chordata;Actinopteri;Scombriformes;Scombridae;Allothunnus;Allothunnus fallai
FISHCARD_miu_358.1	Eukaryota;Chordata;Actinopteri;Scombriformes;Scombridae;Scomberomorus;Scomberomorus sierra
FISHCARD_miu_359.1	Eukaryota;Chordata;Actinopteri;Scombriformes;Scombridae;Thunnus;Thunnus albacares
FISHCARD_miu_360.1	Eukaryota;Chordata;Actinopteri;Perciformes;Scorpaenidae;Scorpaena;Scorpaena guttata
FISHCARD_miu_361.1	Eukaryota;Chordata;Actinopteri;Perciformes;Scorpaenidae;Scorpaenodes;Scorpaenodes xyris
FISHCARD_miu_362.1	Eukaryota;Chordata;Actinopteri;Perciformes;Serranidae;Hemanthias;Hemanthias signifer
FISHCARD_miu_363.1	Eukaryota;Chordata;Actinopteri;Perciformes;Serranidae;Mycteroperca;Mycteroperca xenarcha
FISHCARD_miu_364.1	Eukaryota;Chordata;Actinopteri;Perciformes;Serranidae;Paralabrax;Paralabrax auroguttatus
FISHCARD_miu_365.1	Eukaryota;Chordata;Actinopteri;Perciformes;Serranidae;Paralabrax;Paralabrax clathratus
FISHCARD_miu_366.1	Eukaryota;Chordata;Actinopteri;Perciformes;Serranidae;Paralabrax;Paralabrax maculatofasciatus
FISHCARD_miu_367.1	Eukaryota;Chordata;Actinopteri;;Sphyraenidae;Sphyraena;Sphyraena ensis
FISHCARD_miu_368.1	Eukaryota;Chordata;Chondrichthyes;Carcharhiniformes;Carcharhinidae;Sphyrna;Sphyrna lewini
FISHCARD_miu_369.1	Eukaryota;Chordata;Actinopteri;Stomiiformes;Sternoptychidae;Argyropelecus;Argyropelecus sladeni
FISHCARD_miu_370.1	Eukaryota;Chordata;Actinopteri;Perciformes;Stichaeidae;Esselenichthys;Esselenichthys carli
FISHCARD_miu_371.1	Eukaryota;Chordata;Actinopteri;Perciformes;Stichaeidae;Kasatkia;Kasatkia seigeli
FISHCARD_miu_372.1	Eukaryota;Chordata;Actinopteri;Perciformes;Stichaeidae;Plectobranchus;Plectobranchus evides
FISHCARD_miu_373.1	Eukaryota;Chordata;Actinopteri;Scombriformes;Stromateidae;Peprilus;Peprilus simillimus
FISHCARD_miu_374.1	Eukaryota;Chordata;Actinopteri;Syngnathiformes;Syngnathidae;Syngnathus;Syngnathus californiensis
FISHCARD_miu_375.1	Eukaryota;Chordata;Actinopteri;Aulopiformes;Synodontidae;Synodus;Synodus lacertinus
FISHCARD_miu_376.1	Eukaryota;Chordata;Actinopteri;Aulopiformes;Synodontidae;Synodus;Synodus lucioceps
FISHCARD_miu_377.1	Eukaryota;Chordata;Actinopteri;Scombriformes;Tetragonuridae;Tetragonurus;Tetragonurus cuvieri
FISHCARD_miu_378.1	Eukaryota;Chordata;Actinopteri;Tetraodontiformes;Tetraodontidae;Sphoeroides;Sphoeroides annulatus
FISHCARD_miu_379.1	Eukaryota;Chordata;Actinopteri;Lampriformes;Trachipteridae;Desmodema;Desmodema lorum
FISHCARD_miu_380.1	Eukaryota;Chordata;Actinopteri;Scombriformes;Trichiuridae;Assurger;Assurger anzac
FISHCARD_miu_381.1	Eukaryota;Chordata;Actinopteri;Perciformes;Triglidae;Prionotus;Prionotus stephanophrys
FISHCARD_miu_382.1	Eukaryota;Chordata;Actinopteri;Perciformes;Zaproridae;Zaprora;Zaprora silenus
FISHCARD_miu_383.1	Eukaryota;Chordata;Actinopteri;Perciformes;Zoarcidae;Lycenchelys;Lycenchelys crotalinus
FISHCARD_miu_384.1	Eukaryota;Chordata;Actinopteri;Perciformes;Zoarcidae;Lycodes;Lycodes cortezianus
FISHCARD_miu_385.1	Eukaryota;Chordata;Actinopteri;Perciformes;Zoarcidae;Lycodes;Lycodes diapterus
FISHCARD_miu_386.1	Eukaryota;Chordata;Actinopteri;Perciformes;Zoarcidae;Lycodes;Lycodes pacificus
FISHCARD_miu_387.1	Eukaryota;Chordata;Actinopteri;Perciformes;Zoarcidae;Lyconema;Lyconema barbatum
FISHCARD_miu_388.1	Eukaryota;Chordata;Actinopteri;Gerreiformes;Gerreidae;Eucinostomus;Eucinostomus argenteus
FISHCARD_miu_389.1	Eukaryota;Chordata;Actinopteri;Perciformes;Cottidae;Ruscarius;Ruscarius creaseri
FISHCARD_miu_390.1	Eukaryota;Chordata;Actinopteri;Perciformes;Stichaeidae;Esselenichthys;Esselenichthys carli
FISHCARD_miu_391.1	Eukaryota;Chordata;Actinopteri;Myctophiformes;Myctophidae;Lampanyctus;Lampanyctus tenuiformis
FISHCARD_miu_392.1	Eukaryota;Chordata;Actinopteri;Tetraodontiformes;Diodontidae;Diodon;Diodon holocanthus
FISHCARD_miu_393.1	Eukaryota;Chordata;Actinopteri;Carangiformes;Nematistiidae;Nematistius;Nematistius pectoralis
FISHCARD_miu_394.1	Eukaryota;Chordata;Actinopteri;Scombriformes;Scombridae;Sarda;Sarda chiliensis
FISHCARD_miu_395.1	Eukaryota;Chordata;Actinopteri;Lutjaniformes;Lutjanidae;Lutjanus;Lutjanus novemfasciatus
FISHCARD_miu_396.1	Eukaryota;Chordata;Actinopteri;Gobiiformes;Gobiidae;Lythrypnus;Lythrypnus zebra
FISHCARD_miu_397.1	Eukaryota;Chordata;Actinopteri;Perciformes;Stichaeidae;Chirolophis;Chirolophis decoratus
FISHCARD_miu_398.1	Eukaryota;Chordata;Actinopteri;Perciformes;Sebastidae;Sebastolobus;Sebastolobus altivelis
FISHCARD_miu_399.1	Eukaryota;Chordata;Actinopteri;Perciformes;Cottidae;Enophrys;Enophrys bison
FISHCARD_miu_400.1	Eukaryota;Chordata;Actinopteri;Perciformes;Cottidae;Icelinus;Icelinus fimbriatus
FISHCARD_miu_401.1	Eukaryota;Chordata;Actinopteri;Gadiformes;Macrouridae;Coryphaenoides;Coryphaenoides yaquinae
FISHCARD_miu_402.1	Eukaryota;Chordata;Actinopteri;Perciformes;Liparidae;Liparis;Liparis florae
FISHCARD_miu_403.1	Eukaryota;Chordata;Actinopteri;Perciformes;Agonidae;Odontopyxis;Odontopyxis trispinosa
FISHCARD_miu_404.1	Eukaryota;Chordata;Actinopteri;Perciformes;Agonidae;Podothecus;Podothecus accipenserinus
FISHCARD_miu_405.1	Eukaryota;Chordata;Actinopteri;Spariformes;Sparidae;Calamus;Calamus brachysomus
FISHCARD_miu_406.1	Eukaryota;Chordata;Actinopteri;;Embiotocidae;Phanerodon;Phanerodon vacca
FISHCARD_miu_407.1	Eukaryota;Chordata;Actinopteri;Perciformes;Stichaeidae;Anoplarchus;Anoplarchus purpurescens
FISHCARD_miu_408.1	Eukaryota;Chordata;Actinopteri;Gadiformes;Gadidae;Microgadus;Microgadus proximus
FISHCARD_miu_409.1	Eukaryota;Chordata;Actinopteri;Gadiformes;Gadidae;Gadus;Gadus chalcogrammus
FISHCARD_miu_410.1	Eukaryota;Chordata;Actinopteri;Carangiformes;Echeneidae;Phtheirichthys;Phtheirichthys lineatus
FISHCARD_miu_411.1	Eukaryota;Chordata;Actinopteri;Istiophoriformes;Istiophoridae;Makaira;Makaira nigricans
FISHCARD_miu_412.1	Eukaryota;Chordata;Actinopteri;Istiophoriformes;Xiphiidae;Xiphias;Xiphias gladius
FISHCARD_miu_413.1	Eukaryota;Chordata;Actinopteri;Perciformes;Hexagrammidae;Hexagrammos;Hexagrammos stelleri
FISHCARD_miu_414.1	Eukaryota;Chordata;Actinopteri;Perciformes;Cottidae;Enophrys;Enophrys bison
FISHCARD_miu_415.1	Eukaryota;Chordata;Actinopteri;Perciformes;Agonidae;Agonopsis;Agonopsis sterletus
FISHCARD_miu_416.1	Eukaryota;Chordata;Actinopteri;Perciformes;Stichaeidae;Anoplarchus;Anoplarchus purpurescens
FISHCARD_miu_417.1	Eukaryota;Chordata;Actinopteri;Perciformes;Pholidae;Apodichthys;Apodichthys flavidus
FISHCARD_miu_418.1	Eukaryota;Chordata;Actinopteri;Perciformes;Stichaeidae;Chirolophis;Chirolophis decoratus
FISHCARD_miu_419.1	Eukaryota;Chordata;Actinopteri;Perciformes;Pholidae;Pholis;Pholis ornata
FISHCARD_miu_420.1	Eukaryota;Chordata;Actinopteri;Gadiformes;Macrouridae;Coryphaenoides;Coryphaenoides yaquinae
FISHCARD_miu_421.1	Eukaryota;Chordata;Actinopteri;Pleuronectiformes;Pleuronectidae;Lepidopsetta;Lepidopsetta bilineata
FISHCARD_miu_422.1	Eukaryota;Chordata;Actinopteri;Pleuronectiformes;Pleuronectidae;Parophrys;Parophrys vetulus
FISHCARD_miu_423.1	Eukaryota;Chordata;Actinopteri;Pleuronectiformes;Pleuronectidae;Platichthys;Platichthys stellatus
FISHCARD_miu_424.1	Eukaryota;Chordata;Actinopteri;Pleuronectiformes;Pleuronectidae;Pleuronichthys;Pleuronichthys coenosus
FISHCARD_miu_425.1	Eukaryota;Chordata;Actinopteri;;Pomacanthidae;Pomacanthus;Pomacanthus zonipectus
FISHCARD_miu_426.1	Eukaryota;Chordata;Actinopteri;Tetraodontiformes;Balistidae;Balistes;Sufflamen verres
FISHCARD_miu_427.1	Eukaryota;Chordata;Actinopteri;Perciformes;Serranidae;Paranthias;Cephalopholis colonus
FISHCARD_miu_428.1	Eukaryota;Chordata;Actinopteri;Carangiformes;Echeneidae;Echeneis;Echeneis naucrates
FISHCARD_miu_429.1	Eukaryota;Chordata;Actinopteri;Carangiformes;Echeneidae;Remora;Remora australis
FISHCARD_miu_430.1	Eukaryota;Chordata;Actinopteri;Carangiformes;Echeneidae;Remora;Remora brachyptera
FISHCARD_miu_431.1	Eukaryota;Chordata;Actinopteri;Perciformes;Cottidae;Hemilepidotus;Hemilepidotus hemilepidotus
FISHCARD_miu_432.1	Eukaryota;Chordata;Actinopteri;Stomiiformes;Sternoptychidae;Sternoptyx;Sternoptyx obscura
FISHCARD_miu_433.1	Eukaryota;Chordata;Actinopteri;Stomiiformes;Diplophidae;Diplophos;Diplophos taenia
FISHCARD_miu_434.1	Eukaryota;Chordata;Actinopteri;Blenniiformes;Labrisomidae;Paraclinus;Paraclinus integripinnis
FISHCARD_miu_435.1	Eukaryota;Chordata;Actinopteri;Stomiiformes;Gonostomatidae;Cyclothone;Cyclothone pallida
FISHCARD_miu_436.1	Eukaryota;Chordata;Actinopteri;Alepocephaliformes;Alepocephalidae;Bajacalifornia;Bajacalifornia burragei
FISHCARD_miu_437.1	Eukaryota;Chordata;Actinopteri;Gadiformes;Macrouridae;Nezumia;Nezumia liolepis
FISHCARD_miu_438.1	Eukaryota;Chordata;Actinopteri;Alepocephaliformes;Platytroctidae;Holtbyrnia;Holtbyrnia latifrons
FISHCARD_miu_439.1	Eukaryota;Chordata;Actinopteri;Argentiniformes;Bathylagidae;Lipolagus;Lipolagus ochotensis
FISHCARD_miu_440.1	Eukaryota;Chordata;Actinopteri;Beryciformes;Melamphaidae;Poromitra;Poromitra crassiceps
FISHCARD_miu_441.1	Eukaryota;Chordata;Actinopteri;Syngnathiformes;Syngnathidae;Syngnathus;Syngnathus californiensis
FISHCARD_miu_442.1	Eukaryota;Chordata;Actinopteri;Perciformes;Zoarcidae;Lycenchelys;Lycenchelys camchatica
FISHCARD_miu_443.1	Eukaryota;Chordata;Actinopteri;Ophidiiformes;Bythitidae;Cataetyx;Cataetyx rubrirostris
FISHCARD_miu_444.1	Eukaryota;Chordata;Actinopteri;Perciformes;Zoarcidae;Lycodapus;Lycodapus mandibularis
FISHCARD_miu_445.1	Eukaryota;Chordata;Actinopteri;Clupeiformes;Clupeidae;Alosa;Alosa sapidissima
FISHCARD_miu_446.1	Eukaryota;Chordata;Actinopteri;Perciformes;Anoplopomatidae;Anoplopoma;Anoplopoma fimbria
FISHCARD_miu_447.1	Eukaryota;Chordata;Actinopteri;Pleuronectiformes;Paralichthyidae;Hippoglossina;Hippoglossina stomata
FISHCARD_miu_448.1	Eukaryota;Chordata;Myxini;Myxiniformes;Myxinidae;Eptatretus;Eptatretus deani
FISHCARD_miu_449.1	Eukaryota;Chordata;Actinopteri;Gadiformes;Moridae;Antimora;Antimora microlepis
FISHCARD_miu_450.1	Eukaryota;Chordata;Actinopteri;Gadiformes;Moridae;Physiculus;Physiculus rastrelliger
FISHCARD_miu_451.1	Eukaryota;Chordata;Actinopteri;Perciformes;Zoarcidae;Bothrocara;Bothrocara brunneum
FISHCARD_miu_452.1	Eukaryota;Chordata;Actinopteri;Alepocephaliformes;Alepocephalidae;Alepocephalus;Alepocephalus tenebrosus
FISHCARD_miu_453.1	Eukaryota;Chordata;Actinopteri;Perciformes;Stichaeidae;Anoplarchus;Anoplarchus insignis
FISHCARD_miu_454.1	Eukaryota;Chordata;Actinopteri;Perciformes;Agonidae;Bathyagonus;Bathyagonus alascanus
FISHCARD_miu_455.1	Eukaryota;Chordata;Actinopteri;Aulopiformes;Scopelarchidae;Benthalbella;Benthalbella dentata
FISHCARD_miu_456.1	Eukaryota;Chordata;Actinopteri;Lophiiformes;Oneirodidae;Bertella;Bertella idiomorpha
FISHCARD_miu_457.1	Eukaryota;Chordata;Actinopteri;Perciformes;Agonidae;Blepsias;Blepsias cirrhosus
FISHCARD_miu_458.1	Eukaryota;Chordata;Actinopteri;Stomiiformes;Stomiidae;Borostomias;Borostomias panamensis
FISHCARD_miu_459.1	Eukaryota;Chordata;Actinopteri;Lophiiformes;Ceratiidae;Ceratias;Ceratias holboelli
FISHCARD_miu_460.1	Eukaryota;Chordata;Actinopteri;Lophiiformes;Oneirodidae;Chaenophryne;Chaenophryne longiceps
FISHCARD_miu_461.1	Eukaryota;Chordata;Actinopteri;Lophiiformes;Oneirodidae;Chaenophryne;Chaenophryne melanorhabdus
FISHCARD_miu_462.1	Eukaryota;Chordata;Actinopteri;Perciformes;Stichaeidae;Chirolophis;Chirolophis nugator
FISHCARD_miu_463.1	Eukaryota;Chordata;Actinopteri;Perciformes;Cottidae;Cottus;Cottus asper
FISHCARD_miu_464.1	Eukaryota;Chordata;Actinopteri;Perciformes;Cryptacanthodidae;Cryptacanthodes;Cryptacanthodes giganteus
FISHCARD_miu_465.1	Eukaryota;Chordata;Actinopteri;Perciformes;Gasterosteidae;Gasterosteus;Gasterosteus aculeatus
FISHCARD_miu_466.1	Eukaryota;Chordata;Actinopteri;Myctophiformes;Myctophidae;Gonichthys;Gonichthys tenuiculus
FISHCARD_miu_467.1	Eukaryota;Chordata;Actinopteri;Perciformes;Cottidae;Hemilepidotus;Hemilepidotus spinosus
FISHCARD_miu_468.1	Eukaryota;Chordata;Actinopteri;Perciformes;Hexagrammidae;Hexagrammos;Hexagrammos lagocephalus
FISHCARD_miu_469.1	Eukaryota;Chordata;Actinopteri;Pleuronectiformes;Pleuronectidae;Hippoglossus;Hippoglossus stenolepis
FISHCARD_miu_470.1	Eukaryota;Chordata;Actinopteri;Myctophiformes;Myctophidae;Hygophum;Hygophum atratum
FISHCARD_miu_471.1	Eukaryota;Chordata;Actinopteri;Myctophiformes;Myctophidae;Hygophum;Hygophum proximum
FISHCARD_miu_472.1	Eukaryota;Chordata;Actinopteri;Osmeriformes;Osmeridae;Hypomesus;Hypomesus pretiosus
FISHCARD_miu_473.1	Eukaryota;Chordata;Actinopteri;Perciformes;Cottidae;Icelinus;Icelinus tenuis
FISHCARD_miu_474.1	Eukaryota;Chordata;Actinopteri;Myctophiformes;Myctophidae;Lampanyctus;Lampanyctus parvicauda
FISHCARD_miu_475.1	Eukaryota;Chordata;Hyperoartia;Petromyzontiformes;Petromyzontidae;Entosphenus;Entosphenus tridentatus
FISHCARD_miu_476.1	Eukaryota;Chordata;Actinopteri;Gobiiformes;Gobiidae;Lepidogobius;Lepidogobius lepidus
FISHCARD_miu_477.1	Eukaryota;Chordata;Actinopteri;Scombriformes;Trichiuridae;Lepidopus;Lepidopus fitchi
FISHCARD_miu_478.1	Eukaryota;Chordata;Actinopteri;Perciformes;Liparidae;Liparis;Liparis fucensis
FISHCARD_miu_479.1	Eukaryota;Chordata;Actinopteri;Perciformes;Liparidae;Liparis;Liparis pulchellus
FISHCARD_miu_480.1	Eukaryota;Chordata;Actinopteri;Lophiiformes;Oneirodidae;Lophodolos;Lophodolos acanthognathus
FISHCARD_miu_481.1	Eukaryota;Chordata;Actinopteri;Perciformes;Stichaeidae;Lumpenus;Lumpenus sagitta
FISHCARD_miu_482.1	Eukaryota;Chordata;Actinopteri;Lophiiformes;Melanocetidae;Melanocetus;Melanocetus johnsonii
FISHCARD_miu_483.1	Eukaryota;Chordata;Actinopteri;Alepocephaliformes;Platytroctidae;Mirorictus;Mirorictus taningi
FISHCARD_miu_484.1	Eukaryota;Chordata;Actinopteri;Myctophiformes;Myctophidae;Myctophum;Myctophum aurolaternatum
FISHCARD_miu_485.1	Eukaryota;Chordata;Actinopteri;Myctophiformes;Myctophidae;Myctophum;Myctophum lychnobium
FISHCARD_miu_486.1	Eukaryota;Chordata;Actinopteri;Myctophiformes;Myctophidae;Myctophum;Myctophum nitidulum
FISHCARD_miu_487.1	Eukaryota;Chordata;Actinopteri;Perciformes;Agonidae;Nautichthys;Nautichthys oculofasciatus
FISHCARD_miu_488.1	Eukaryota;Chordata;Actinopteri;Salmoniformes;Salmonidae;Oncorhynchus;Oncorhynchus gorbuscha
FISHCARD_miu_489.1	Eukaryota;Chordata;Actinopteri;Salmoniformes;Salmonidae;Oncorhynchus;Oncorhynchus keta
FISHCARD_miu_490.1	Eukaryota;Chordata;Actinopteri;Salmoniformes;Salmonidae;Oncorhynchus;Oncorhynchus kisutch
FISHCARD_miu_491.1	Eukaryota;Chordata;Actinopteri;Lophiiformes;Oneirodidae;Oneirodes;Oneirodes thompsoni
FISHCARD_miu_492.1	Eukaryota;Chordata;Actinopteri;Perciformes;Pholidae;Pholis;Pholis clemensi
FISHCARD_miu_493.1	Eukaryota;Chordata;Actinopteri;Perciformes;Pholidae;Pholis;Pholis laeta
FISHCARD_miu_494.1	Eukaryota;Chordata;Actinopteri;Perciformes;Stichaeidae;Poroclinus;Poroclinus rothrocki
FISHCARD_miu_495.1	Eukaryota;Chordata;Actinopteri;Pleuronectiformes;Pleuronectidae;Reinhardtius;Reinhardtius hippoglossoides
FISHCARD_miu_496.1	Eukaryota;Chordata;Actinopteri;Osmeriformes;Osmeridae;Spirinchus;Spirinchus starksi
FISHCARD_miu_497.1	Eukaryota;Chordata;Actinopteri;Perciformes;Cottidae;Synchirus;Synchirus gilli
FISHCARD_miu_498.1	Eukaryota;Chordata;Actinopteri;Gadiformes;Gadidae;Gadus;Gadus chalcogrammus
FISHCARD_miu_499.1	Eukaryota;Chordata;Actinopteri;Perciformes;Trichodontidae;Trichodon;Trichodon trichodon
FISHCARD_miu_500.1	Eukaryota;Chordata;Actinopteri;Perciformes;Pholidae;Phytichthys;Phytichthys chirus
FISHCARD_miu_501.1	Eukaryota;Chordata;Actinopteri;Perciformes;Stichaeidae;Xiphister;Xiphister atropurpureus
FISHCARD_miu_502.1	Eukaryota;Chordata;Actinopteri;Aulopiformes;Alepisauridae;Anotopterus;Anotopterus pharao
FISHCARD_miu_503.1	Eukaryota;Chordata;Actinopteri;Scombriformes;Trichiuridae;Aphanopus;Aphanopus arigato
FISHCARD_miu_504.1	Eukaryota;Chordata;Actinopteri;Stomiiformes;Sternoptychidae;Argyropelecus;Argyropelecus aculeatus
FISHCARD_miu_505.1	Eukaryota;Chordata;Actinopteri;Perciformes;Cottidae;Artedius;Artedius harringtoni
FISHCARD_miu_506.1	Eukaryota;Chordata;Actinopteri;Perciformes;Liparidae;Careproctus;Careproctus cypselurus
FISHCARD_miu_507.1	Eukaryota;Chordata;Actinopteri;Scombriformes;Caristiidae;Caristius;Caristius macropus
FISHCARD_miu_508.1	Eukaryota;Chordata;Actinopteri;Perciformes;Stichaeidae;Cebidichthys;Cebidichthys violaceus
FISHCARD_miu_509.1	Eukaryota;Chordata;Actinopteri;Perciformes;Cottidae;Clinocottus;Clinocottus acuticeps
FISHCARD_miu_510.1	Eukaryota;Chordata;Actinopteri;Perciformes;Cottidae;Clinocottus;Clinocottus embryum
FISHCARD_miu_511.1	Eukaryota;Chordata;Actinopteri;Perciformes;Cottidae;Clinocottus;Clinocottus globiceps
FISHCARD_miu_512.1	Eukaryota;Chordata;Actinopteri;Perciformes;Cottidae;Clinocottus;Clinocottus recalvus
FISHCARD_miu_513.1	Eukaryota;Chordata;Actinopteri;Perciformes;Cryptacanthodidae;Cryptacanthodes;Cryptacanthodes aleutensis
FISHCARD_miu_514.1	Eukaryota;Chordata;Actinopteri;Gobiiformes;Eleotridae;Dormitator;Dormitator latifrons
FISHCARD_miu_515.1	Eukaryota;Chordata;Actinopteri;Perciformes;Liparidae;Elassodiscus;Elassodiscus caudatus
FISHCARD_miu_516.1	Eukaryota;Chordata;Actinopteri;Anguilliformes;Eurypharyngidae;Eurypharynx;Eurypharynx pelecanoides
FISHCARD_miu_517.1	Eukaryota;Chordata;Actinopteri;Blenniiformes;Clinidae;Gibbonsia;Gibbonsia montereyensis
FISHCARD_miu_518.1	Eukaryota;Chordata;Actinopteri;Scombriformes;Chiasmodontidae;Kali;Kali kerberti
FISHCARD_miu_519.1	Eukaryota;Chordata;Actinopteri;Perciformes;Liparidae;Lipariscus;Lipariscus nanus
FISHCARD_miu_520.1	Eukaryota;Chordata;Actinopteri;Perciformes;Zoarcidae;Lycodapus;Lycodapus fierasfer
FISHCARD_miu_521.1	Eukaryota;Chordata;Actinopteri;Alepocephaliformes;Platytroctidae;Maulisia;Maulisia mauli
FISHCARD_miu_522.1	Eukaryota;Chordata;Actinopteri;Perciformes;Cottidae;Oligocottus;Oligocottus maculosus
FISHCARD_miu_523.1	Eukaryota;Chordata;Actinopteri;Perciformes;Cottidae;Oligocottus;Oligocottus snyderi
FISHCARD_miu_524.1	Eukaryota;Chordata;Actinopteri;Salmoniformes;Salmonidae;Oncorhynchus;Oncorhynchus mykiss
FISHCARD_miu_525.1	Eukaryota;Chordata;Actinopteri;Perciformes;Liparidae;Paraliparis;Paraliparis pectoralis
FISHCARD_miu_526.1	Eukaryota;Chordata;Actinopteri;Perciformes;Hexagrammidae;Pleurogrammus;Pleurogrammus monopterygius
FISHCARD_miu_527.1	Eukaryota;Chordata;Actinopteri;Perciformes;Cottidae;Radulinus;Radulinus asprellus
FISHCARD_miu_528.1	Eukaryota;Chordata;Actinopteri;Perciformes;Liparidae;Rhinoliparis;Rhinoliparis barbulifer
FISHCARD_miu_529.1	Eukaryota;Chordata;Actinopteri;Anguilliformes;Serrivomeridae;Serrivomer;Serrivomer jesperseni
FISHCARD_miu_530.1	Eukaryota;Chordata;Actinopteri;Anguilliformes;Serrivomeridae;Serrivomer;Serrivomer sector
FISHCARD_miu_531.1	Eukaryota;Chordata;Actinopteri;Alepocephaliformes;Alepocephalidae;Talismania;Talismania bifurcata
FISHCARD_miu_532.1	Eukaryota;Chordata;Actinopteri;Istiophoriformes;Istiophoridae;Kajikia;Kajikia audax
FISHCARD_miu_533.1	Eukaryota;Chordata;Actinopteri;Perciformes;Cottidae;Zesticelus;Zesticelus profundorum
FISHCARD_miu_534.1	Eukaryota;Chordata;Actinopteri;Perciformes;Serranidae;Dermatolepis;Dermatolepis dermatolepis
FISHCARD_miu_535.1	Eukaryota;Chordata;Actinopteri;Clupeiformes;Clupeidae;Opisthonema;Opisthonema medirastre
FISHCARD_miu_536.1	Eukaryota;Chordata;Actinopteri;Myctophiformes;Myctophidae;Parvilux;Parvilux ingens
FISHCARD_miu_537.1	Eukaryota;Chordata;Actinopteri;Beryciformes;Barbourisiidae;Barbourisia;Barbourisia rufa
FISHCARD_miu_538.1	Eukaryota;Chordata;Actinopteri;Myctophiformes;Myctophidae;Lampanyctus;Lampanyctus festivus
FISHCARD_miu_539.1	Eukaryota;Chordata;Actinopteri;Stomiiformes;Phosichthyidae;Vinciguerria;Vinciguerria poweriae
FISHCARD_miu_540.1	Eukaryota;Chordata;Actinopteri;Chaetodontiformes;Chaetodontidae;Prognathodes;Prognathodes falcifer
FISHCARD_miu_541.1	Eukaryota;Chordata;Actinopteri;Myctophiformes;Myctophidae;Bolinichthys;Bolinichthys longipes
FISHCARD_miu_542.1	Eukaryota;Chordata;Actinopteri;Tetraodontiformes;Balistidae;Xanthichthys;Xanthichthys mento
FISHCARD_miu_543.1	Eukaryota;Chordata;Actinopteri;Tetraodontiformes;Tetraodontidae;Lagocephalus;Lagocephalus lagocephalus
FISHCARD_miu_544.1	Eukaryota;Chordata;Actinopteri;Tetraodontiformes;Diodontidae;Diodon;Diodon hystrix
FISHCARD_miu_545.1	Eukaryota;Chordata;Actinopteri;Stomiiformes;Gonostomatidae;Cyclothone;Cyclothone atraria
FISHCARD_miu_546.1	Eukaryota;Chordata;Actinopteri;Tetraodontiformes;Tetraodontidae;Sphoeroides;Sphoeroides lobatus
FISHCARD_miu_547.1	Eukaryota;Chordata;Actinopteri;Anguilliformes;Ophichthidae;Ophichthus;Ophichthus triserialis
FISHCARD_miu_548.1	Eukaryota;Chordata;Actinopteri;Perciformes;Scorpaenidae;Scorpaena;Scorpaena mystes
FISHCARD_miu_549.1	Eukaryota;Chordata;Actinopteri;Carangiformes;Carangidae;Selene;Selene peruviana
FISHCARD_miu_550.1	Eukaryota;Chordata;Actinopteri;Carangiformes;Carangidae;Trachinotus;Trachinotus rhodopus
FISHCARD_miu_551.1	Eukaryota;Chordata;Actinopteri;Carangiformes;Carangidae;Chloroscombrus;Chloroscombrus orqueta
FISHCARD_miu_552.1	Eukaryota;Chordata;Actinopteri;Lutjaniformes;Haemulidae;Microlepidotus;Microlepidotus inornatus
FISHCARD_miu_553.1	Eukaryota;Chordata;Actinopteri;Kurtiformes;Apogonidae;Apogon;Apogon guadalupensis
FISHCARD_miu_554.1	Eukaryota;Chordata;Actinopteri;Uranoscopiformes;Uranoscopidae;Astroscopus;Astroscopus zephyreus
FISHCARD_miu_555.1	Eukaryota;Chordata;Actinopteri;Kurtiformes;Apogonidae;Apogon;Apogon pacificus
FISHCARD_miu_556.1	Eukaryota;Chordata;Actinopteri;Perciformes;Serranidae;Diplectrum;Diplectrum maximum
FISHCARD_miu_557.1	Eukaryota;Chordata;Actinopteri;Syngnathiformes;Fistulariidae;Fistularia;Fistularia corneta
FISHCARD_miu_558.1	Eukaryota;Chordata;Actinopteri;Gonorynchiformes;Chanidae;Chanos;Chanos chanos
FISHCARD_miu_559.1	Eukaryota;Chordata;Actinopteri;Perciformes;Serranidae;Epinephelus;Epinephelus analogus
FISHCARD_miu_560.1	Eukaryota;Chordata;Actinopteri;Clupeiformes;Clupeidae;Harengula;Harengula thrissina
FISHCARD_miu_561.1	Eukaryota;Chordata;Actinopteri;Perciformes;Cottidae;Leiocottus;Leiocottus hirundo
FISHCARD_miu_562.1	Eukaryota;Chordata;Actinopteri;Beryciformes;Melamphaidae;Melamphaes;Melamphaes parvus
FISHCARD_miu_563.1	Eukaryota;Chordata;Actinopteri;Beloniformes;Exocoetidae;Fodiator;Fodiator acutus
FISHCARD_miu_564.1	Eukaryota;Chordata;Actinopteri;Myctophiformes;Myctophidae;Nannobrachium;Nannobrachium regale
FISHCARD_miu_565.1	Eukaryota;Chordata;Actinopteri;Chaetodontiformes;Chaetodontidae;Chaetodon;Chaetodon humeralis
FISHCARD_miu_566.1	Eukaryota;Chordata;Actinopteri;Gerreiformes;Gerreidae;Eucinostomus;Eucinostomus currani
FISHCARD_miu_567.1	Eukaryota;Chordata;Actinopteri;Perciformes;Cottidae;Cottus;Cottus aleuticus
FISHCARD_miu_568.1	Eukaryota;Chordata;Actinopteri;Lutjaniformes;Lutjanidae;Lutjanus;Lutjanus colorado
FISHCARD_miu_569.1	Eukaryota;Chordata;Actinopteri;Perciformes;Triglidae;Bellator;Bellator xenisma
FISHCARD_miu_570.1	Eukaryota;Chordata;Actinopteri;Tetraodontiformes;Diodontidae;Chilomycterus;Chilomycterus reticulatus
FISHCARD_miu_571.1	Eukaryota;Chordata;Actinopteri;Stomiiformes;Phosichthyidae;Vinciguerria;Vinciguerria lucetia
FISHCARD_miu_572.1	Eukaryota;Chordata;Actinopteri;Myctophiformes;Myctophidae;Diogenichthys;Diogenichthys laternatus
FISHCARD_miu_573.1	Eukaryota;Chordata;Actinopteri;Carangiformes;Carangidae;Seriola;Seriola rivoliana
FISHCARD_miu_574.1	Eukaryota;Chordata;Actinopteri;Perciformes;Serranidae;Hyporthodus;Hyporthodus acanthistius
FISHCARD_miu_575.1	Eukaryota;Chordata;Actinopteri;Stomiiformes;Sternoptychidae;Argyropelecus;Argyropelecus lychnus
FISHCARD_miu_576.1	Eukaryota;Chordata;Actinopteri;Lophiiformes;Ogcocephalidae;Zalieutes;Zalieutes elater
FISHCARD_miu_577.1	Eukaryota;Chordata;Actinopteri;Carangiformes;Carangidae;Decapterus;Decapterus muroadsi
FISHCARD_miu_578.1	Eukaryota;Chordata;Actinopteri;Carangiformes;Carangidae;Uraspis;Uraspis helvola
FISHCARD_miu_579.1	Eukaryota;Chordata;Actinopteri;Carangiformes;Carangidae;Naucrates;Naucrates ductor
FISHCARD_miu_580.1	Eukaryota;Chordata;Actinopteri;Perciformes;Serranidae;Paralabrax;Paralabrax nebulifer
FISHCARD_miu_581.1	Eukaryota;Chordata;Actinopteri;Clupeiformes;Clupeidae;Sardinops;Sardinops sagax
FISHCARD_miu_582.1	Eukaryota;Chordata;Actinopteri;Blenniiformes;Gobiesocidae;Gobiesox;Gobiesox rhessodon
FISHCARD_miu_583.1	Eukaryota;Chordata;Actinopteri;Carangiformes;Carangidae;Trachinotus;Trachinotus paitensis
FISHCARD_miu_584.1	Eukaryota;Chordata;Actinopteri;Perciformes;Serranidae;Pronotogrammus;Pronotogrammus multifasciatus
FISHCARD_miu_585.1	Eukaryota;Chordata;Actinopteri;Perciformes;Liparidae;Nectoliparis;Nectoliparis pelagicus
FISHCARD_miu_586.1	Eukaryota;Chordata;Actinopteri;Argentiniformes;Opisthoproctidae;Dolichopteryx;Dolichopteryx longipes
FISHCARD_miu_587.1	Eukaryota;Chordata;Actinopteri;Beloniformes;Hemiramphidae;Hemiramphus;Hemiramphus saltator
FISHCARD_miu_588.1	Eukaryota;Chordata;Actinopteri;Pleuronectiformes;Pleuronectidae;Isopsetta;Isopsetta isolepis
FISHCARD_miu_589.1	Eukaryota;Chordata;Actinopteri;Pleuronectiformes;Pleuronectidae;Atheresthes;Atheresthes stomias
FISHCARD_miu_590.1	Eukaryota;Chordata;Actinopteri;Gadiformes;Macrouridae;Albatrossia;Albatrossia pectoralis
FISHCARD_miu_591.1	Eukaryota;Chordata;Actinopteri;Carangiformes;Echeneidae;Phtheirichthys;Phtheirichthys lineatus
FISHCARD_miu_592.1	Eukaryota;Chordata;Actinopteri;Syngnathiformes;Fistulariidae;Fistularia;Fistularia corneta
FISHCARD_miu_593.1	Eukaryota;Chordata;Actinopteri;Syngnathiformes;Syngnathidae;Syngnathus;Syngnathus auliscus
FISHCARD_miu_594.1	Eukaryota;Chordata;Actinopteri;Beryciformes;Melamphaidae;Melamphaes;Melamphaes parvus
FISHCARD_miu_595.1	Eukaryota;Chordata;Actinopteri;Stomiiformes;Sternoptychidae;Argyropelecus;Argyropelecus sladeni
FISHCARD_miu_596.1	Eukaryota;Chordata;Actinopteri;Syngnathiformes;Callionymidae;Synchiropus;Synchiropus atrilabiatus
FISHCARD_miu_597.1	Eukaryota;Chordata;Actinopteri;Myctophiformes;Myctophidae;Diogenichthys;Diogenichthys laternatus
FISHCARD_miu_598.1	Eukaryota;Chordata;Actinopteri;Myctophiformes;Myctophidae;Protomyctophum;Protomyctophum crockeri
FISHCARD_miu_599.1	Eukaryota;Chordata;Actinopteri;Myctophiformes;Myctophidae;Ceratoscopelus;Ceratoscopelus townsendi
FISHCARD_miu_600.1	Eukaryota;Chordata;Actinopteri;Myctophiformes;Myctophidae;Triphoturus;Triphoturus mexicanus
FISHCARD_miu_601.1	Eukaryota;Chordata;Actinopteri;Myctophiformes;Myctophidae;Stenobrachius;Stenobrachius leucopsarus
FISHCARD_miu_602.1	Eukaryota;Chordata;Actinopteri;Myctophiformes;Myctophidae;Diaphus;Diaphus theta
FISHCARD_miu_603.1	Eukaryota;Chordata;Actinopteri;Gadiformes;Macrouridae;Coelorinchus;Coelorinchus scaphopsis
FISHCARD_miu_604.1	Eukaryota;Chordata;Actinopteri;Gadiformes;Macrouridae;Coryphaenoides;Coryphaenoides filifer
FISHCARD_miu_605.1	Eukaryota;Chordata;Actinopteri;Blenniiformes;Chaenopsidae;Coralliozetus;Coralliozetus springeri
FISHCARD_miu_606.1	Eukaryota;Chordata;Actinopteri;Blenniiformes;Chaenopsidae;Coralliozetus;Coralliozetus springeri
FISHCARD_miu_607.1	Eukaryota;Chordata;Actinopteri;Syngnathiformes;Syngnathidae;Syngnathus;Syngnathus leptorhynchus
FISHCARD_miu_608.1	Eukaryota;Chordata;Actinopteri;Perciformes;Agonidae;Bathyagonus;Bathyagonus nigripinnis
FISHCARD_miu_609.1	Eukaryota;Chordata;Actinopteri;Clupeiformes;Clupeidae;Clupea;Clupea pallasii
FISHCARD_miu_610.1	Eukaryota;Chordata;Actinopteri;Syngnathiformes;Syngnathidae;Syngnathus;Syngnathus auliscus
FISHCARD_miu_611.1	Eukaryota;Chordata;Actinopteri;Myctophiformes;Myctophidae;Tarletonbeania;Tarletonbeania crenularis
FISHCARD_miu_612.1	Eukaryota;Chordata;Actinopteri;Pempheriformes;Howellidae;Bathysphyraenops;Bathysphyraenops simplex
FISHCARD_miu_613.1	Eukaryota;Chordata;Actinopteri;Scombriformes;Scombridae;Acanthocybium;Acanthocybium solandri
FISHCARD_miu_614.1	Eukaryota;Chordata;Actinopteri;Scombriformes;Scombridae;Euthynnus;Euthynnus lineatus
FISHCARD_miu_615.1	Eukaryota;Chordata;Chondrichthyes;Lamniformes;Alopiidae;Alopias;Alopias superciliosus
FISHCARD_miu_616.1	Eukaryota;Chordata;Chondrichthyes;Carcharhiniformes;Carcharhinidae;Carcharhinus;Carcharhinus longimanus
FISHCARD_miu_617.1	Eukaryota;Chordata;Chondrichthyes;Carcharhiniformes;Carcharhinidae;Prionace;Prionace glauca
FISHCARD_miu_618.1	Eukaryota;Chordata;Chondrichthyes;Chimaeriformes;Chimaeridae;Hydrolagus;Hydrolagus colliei
FISHCARD_miu_619.1	Eukaryota;Chordata;Chondrichthyes;Squaliformes;Somniosidae;Somniosus;Somniosus pacificus
FISHCARD_miu_620.1	Eukaryota;Chordata;Chondrichthyes;Myliobatiformes;Dasyatidae;Hypanus;Hypanus dipterurus
FISHCARD_miu_621.1	Eukaryota;Chordata;Chondrichthyes;Lamniformes;Alopiidae;Carcharodon;Carcharodon carcharias
FISHCARD_miu_622.1	Eukaryota;Chordata;Chondrichthyes;Hexanchiformes;Hexanchidae;Hexanchus;Hexanchus griseus
FISHCARD_miu_623.1	Eukaryota;Chordata;Actinopteri;Lophiiformes;Himantolophidae;Himantolophus;Himantolophus sagamius
FISHCARD_miu_624.1	Eukaryota;Chordata;Chondrichthyes;Rajiformes;Arhynchobatidae;Bathyraja;Bathyraja trachura
FISHCARD_miu_625.1	Eukaryota;Chordata;Chondrichthyes;;Platyrhinidae;Platyrhinoidis;Platyrhinoidis triseriata
FISHCARD_miu_626.1	Eukaryota;Chordata;Chondrichthyes;Carcharhiniformes;Scyliorhinidae;Parmaturus;Parmaturus xaniurus
FISHCARD_miu_627.1	Eukaryota;Chordata;Chondrichthyes;Carcharhiniformes;Triakidae;Mustelus;Mustelus californicus
FISHCARD_miu_628.1	Eukaryota;Chordata;Chondrichthyes;Carcharhiniformes;Triakidae;Triakis;Triakis semifasciata
FISHCARD_miu_629.1	Eukaryota;Chordata;Chondrichthyes;Myliobatiformes;Urolophidae;Urobatis;Urobatis halleri
FISHCARD_miu_630.1	Eukaryota;Chordata;Chondrichthyes;Lamniformes;Alopiidae;Alopias;Alopias superciliosus
FISHCARD_miu_631.1	Eukaryota;Chordata;Chondrichthyes;Hexanchiformes;Hexanchidae;Notorynchus;Notorynchus cepedianus
FISHCARD_miu_632.1	Eukaryota;Chordata;Chondrichthyes;Lamniformes;Alopiidae;Alopias;Alopias pelagicus
FISHCARD_miu_633.1	Eukaryota;Chordata;Chondrichthyes;Torpediniformes;Torpedinidae;Tetronarce;Tetronarce californica
FISHCARD_miu_634.1	Eukaryota;Chordata;Chondrichthyes;Rajiformes;Rajidae;Raja;Beringraja binoculata
FISHCARD_miu_635.1	Eukaryota;Chordata;Chondrichthyes;Myliobatiformes;Dasyatidae;Pteroplatytrygon;Pteroplatytrygon violacea
FISHCARD_miu_636.1	Eukaryota;Chordata;Chondrichthyes;Carcharhiniformes;Triakidae;Mustelus;Mustelus henlei
FISHCARD_miu_637.1	Eukaryota;Chordata;Chondrichthyes;Carcharhiniformes;Scyliorhinidae;Apristurus;Apristurus brunneus
FISHCARD_miu_638.1	Eukaryota;Chordata;Chondrichthyes;Rajiformes;Rajidae;Raja;Beringraja rhina
FISHCARD_miu_639.1	Eukaryota;Chordata;Chondrichthyes;Carcharhiniformes;Scyliorhinidae;Apristurus;Apristurus kampae
FISHCARD_miu_640.1	Eukaryota;Chordata;Chondrichthyes;Rajiformes;Rajidae;Raja;Beringraja inornata
FISHCARD_miu_641.1	Eukaryota;Chordata;Chondrichthyes;Carcharhiniformes;Scyliorhinidae;Cephaloscyllium;Cephaloscyllium ventriosum
FISHCARD_miu_642.1	Eukaryota;Chordata;Chondrichthyes;Rajiformes;Arhynchobatidae;Bathyraja;Bathyraja interrupta
FISHCARD_miu_643.1	Eukaryota;Chordata;Chondrichthyes;Rajiformes;Rajidae;Raja;Beringraja stellulata
FISHCARD_miu_644.1	Eukaryota;Chordata;Chondrichthyes;Rajiformes;Rajidae;Amblyraja;Amblyraja hyperborea
FISHCARD_miu_645.1	Eukaryota;Chordata;Chondrichthyes;Orectolobiformes;Rhincodontidae;Rhincodon;Rhincodon typus
FISHCARD_miu_646.1	Eukaryota;Chordata;Chondrichthyes;Squaliformes;Squalidae;Squalus;Squalus suckleyi
FISHCARD_miu_647.1	Eukaryota;Chordata;Chondrichthyes;;Squatinidae;Squatina;Squatina californica
FISHCARD_miu_648.1	Eukaryota;Chordata;Chondrichthyes;Lamniformes;Megachasmidae;Megachasma;Megachasma pelagios
FISHCARD_miu_649.1	Eukaryota;Chordata;Chondrichthyes;Carcharhiniformes;Triakidae;Mustelus;Mustelus lunulatus
FISHCARD_miu_650.1	Eukaryota;Chordata;Chondrichthyes;Pristiformes/Rhiniformes group;Rhinobatidae;Zapteryx;Zapteryx exasperata
FISHCARD_miu_651.1	Eukaryota;Chordata;Actinopteri;Scombriformes;Centrolophidae;Icichthys;Icichthys lockingtoni
FISHCARD_miu_652.1	Eukaryota;Chordata;Actinopteri;;Sciaenidae;Roncador;Roncador stearnsii
FISHCARD_miu_653.1	Eukaryota;Chordata;Actinopteri;Stomiiformes;Sternoptychidae;Sternoptyx;Sternoptyx obscura
FISHCARD_miu_654.1	Eukaryota;Chordata;Actinopteri;Perciformes;Liparidae;Nectoliparis;Nectoliparis pelagicus
FISHCARD_miu_655.1	Eukaryota;Chordata;Actinopteri;Anguilliformes;Muraenidae;Gymnothorax;Gymnothorax mordax
FISHCARD_miu_656.1	Eukaryota;Chordata;Actinopteri;Uranoscopiformes;Uranoscopidae;Astroscopus;Astroscopus zephyreus
FISHCARD_miu_657.1	Eukaryota;Chordata;Actinopteri;Stomiiformes;Sternoptychidae;Danaphos;Danaphos oculatus
FISHCARD_miu_661.1	Eukaryota;Chordata;Actinopteri;Pleuronectiformes;Pleuronectidae;Eopsetta;Eopsetta jordani
FISHCARD_miu_662.1	Eukaryota;Chordata;Actinopteri;Perciformes;Aulorhynchidae;Aulorhynchus;Aulorhynchus flavidus
FISHCARD_miu_663.1	Eukaryota;Chordata;Actinopteri;Perciformes;Aulorhynchidae;Aulorhynchus;Aulorhynchus flavidus
FISHCARD_miu_664.1	Eukaryota;Chordata;Actinopteri;Perciformes;Aulorhynchidae;Aulorhynchus;Aulorhynchus flavidus
FISHCARD_miu_665.1	Eukaryota;Chordata;Actinopteri;Scombriformes;Scombridae;Thunnus;Thunnus obesus
FISHCARD_miu_666.1	Eukaryota;Chordata;Actinopteri;Perciformes;Sebastidae;Sebastes;Sebastes reedi
FISHCARD_miu_667.1	Eukaryota;Chordata;Actinopteri;;Embiotocidae;Micrometrus;Micrometrus aurora
FISHCARD_miu_668.1	Eukaryota;Chordata;Actinopteri;;Embiotocidae;Micrometrus;Micrometrus aurora
FISHCARD_miu_669.1	Eukaryota;Chordata;Actinopteri;Tetraodontiformes;Molidae;Ranzania;Ranzania laevis
FISHCARD_miu_670.1	Eukaryota;Chordata;Actinopteri;Tetraodontiformes;Molidae;Mola;Mola mola
FISHCARD_miu_671.1	Eukaryota;Chordata;Actinopteri;Tetraodontiformes;Molidae;Mola;Mola tecta
FISHCARD_miu_672.1	Eukaryota;Chordata;Actinopteri;Tetraodontiformes;Molidae;Mola;Mola alexandrini
FISHCARD_miu_673.1	Eukaryota;Chordata;Actinopteri;Tetraodontiformes;Molidae;Masturus;Masturus lanceolatus
FISHCARD_miu_674.1	Eukaryota;Chordata;Actinopteri;Tetraodontiformes;Molidae;Mola;Mola alexandrini
FISHCARD_miu_675.1	Eukaryota;Chordata;Actinopteri;Tetraodontiformes;Molidae;Ranzania;Ranzania laevis
FISHCARD_miu_676.1	Eukaryota;Chordata;Actinopteri;Perciformes;Serranidae;Paralabrax;Paralabrax nebulifer
FISHCARD_miu_677.1	Eukaryota;Chordata;Actinopteri;Pleuronectiformes;Paralichthyidae;Paralichthys;Paralichthys californicus
FISHCARD_miu_678.1	Eukaryota;Chordata;Actinopteri;Perciformes;Serranidae;Paralabrax;Paralabrax nebulifer
FISHCARD_miu_679.1	Eukaryota;Chordata;Actinopteri;Pleuronectiformes;Paralichthyidae;Paralichthys;Paralichthys californicus
FISHCARD_miu_680.1	Eukaryota;Chordata;Actinopteri;Pleuronectiformes;Paralichthyidae;Paralichthys;Paralichthys californicus
FISHCARD_miu_681.1	Eukaryota;Chordata;Actinopteri;;Sciaenidae;Seriphus;Seriphus politus
FISHCARD_miu_682.1	Eukaryota;Chordata;Actinopteri;Pleuronectiformes;Paralichthyidae;Paralichthys;Paralichthys californicus
FISHCARD_miu_683.1	Eukaryota;Chordata;Actinopteri;Perciformes;Serranidae;Paralabrax;Paralabrax nebulifer
FISHCARD_miu_684.1	Eukaryota;Chordata;Actinopteri;;Sciaenidae;Seriphus;Seriphus politus
FISHCARD_miu_685.1	Eukaryota;Chordata;Actinopteri;;Embiotocidae;Phanerodon;Phanerodon furcatus
FISHCARD_miu_686.1	Eukaryota;Chordata;Actinopteri;Perciformes;Serranidae;Paralabrax;Paralabrax clathratus
FISHCARD_miu_687.1	Eukaryota;Chordata;Actinopteri;Pleuronectiformes;Paralichthyidae;Paralichthys;Paralichthys californicus
FISHCARD_miu_688.1	Eukaryota;Chordata;Actinopteri;Perciformes;Serranidae;Paralabrax;Paralabrax nebulifer
FISHCARD_miu_689.1	Eukaryota;Chordata;Chondrichthyes;Myliobatiformes;Urolophidae;Urobatis;Urobatis halleri
FISHCARD_miu_690.1	Eukaryota;Chordata;Actinopteri;;Sciaenidae;Seriphus;Seriphus politus
FISHCARD_miu_691.1	Eukaryota;Chordata;Actinopteri;;Sciaenidae;Seriphus;Seriphus politus
FISHCARD_miu_692.1	Eukaryota;Chordata;Actinopteri;Perciformes;Serranidae;Paralabrax;Paralabrax clathratus
FISHCARD_miu_693.1	Eukaryota;Chordata;Actinopteri;Pleuronectiformes;Pleuronectidae;Pleuronichthys;Pleuronichthys ritteri
FISHCARD_miu_694.1	Eukaryota;Chordata;Actinopteri;;Sciaenidae;Seriphus;Seriphus politus
FISHCARD_miu_695.1	Eukaryota;Chordata;Actinopteri;Perciformes;Serranidae;Paralabrax;Paralabrax maculatofasciatus
FISHCARD_miu_696.1	Eukaryota;Chordata;Actinopteri;Pleuronectiformes;Paralichthyidae;Paralichthys;Paralichthys californicus
FISHCARD_miu_697.1	Eukaryota;Chordata;Actinopteri;Pleuronectiformes;Cynoglossidae;Symphurus;Symphurus atricaudus
FISHCARD_miu_698.1	Eukaryota;Chordata;Actinopteri;Pleuronectiformes;Pleuronectidae;Pleuronichthys;Pleuronichthys ritteri
FISHCARD_miu_699.1	Eukaryota;Chordata;Actinopteri;Perciformes;Serranidae;Paralabrax;Paralabrax nebulifer
FISHCARD_miu_700.1	Eukaryota;Chordata;Actinopteri;Gobiiformes;Gobiidae;Lythrypnus;Lythrypnus dalli
FISHCARD_miu_701.1	Eukaryota;Chordata;Actinopteri;;Embiotocidae;Embiotoca;Embiotoca caryi
FISHCARD_miu_702.1	Eukaryota;Chordata;Actinopteri;;Sciaenidae;Atractoscion;Atractoscion nobilis
